妇检|000||||早孕,孕前,妇检,诊刮,周孕
病毒性和其他特指的肠道感染|A08|乏力,便血,稀便,黑便|发烧,呕吐,恶心,腹泻,腹痛,腹胀,食欲不振||肠道感染,轮状病毒肠炎,轮状病毒性肠炎,肠道病毒感染,病毒性肠炎,病毒性胃肠炎
其他传染性和未特指病因的胃肠炎和结肠炎|A09|中毒,全身不适,大便干结,头疼,排便困难,皮疹,稀便,肌肉疼痛,肠出血,肠胃气滞,肠道湿热,肠鸣音,胃肠气胀,胸膈烧灼,脐腹痛,腹部压痛,黑便|便秘,便血,发烧,呕吐,恶心,腹痛,腹胀,食欲不振||胃肠炎,感染性腹泻,婴儿腹泻,胃肠型上感,痢疾
呼吸道结核,未经细菌学或组织学所证实|A16|乏力,消化不良,胸痛,身体消瘦,食欲不振|低热,呼吸困难,咳嗽,咳痰,咳血,盗汗||呼吸道结核,肺结核,粟粒性肺结核,淋巴结结核,右肺继发型结核,结核性胸膜炎
其他器官的结核|A18|关节酸痛,压痛,呕吐,尿道灼痛,尿频,恶心,脓疱,腰背疼,食欲不振|乏力,发烧,淋巴结肿大,盗汗,腹痛,身体消瘦||结核,盆腔结核,淋巴结结核,播散性结核病,结核感染,结核病
未特指部位的细菌性感染|A49|上腹疼痛,呕吐,呼吸急促,咳嗽,咽喉疼痛,嗜睡,头疼,寒战,尿道口有白膜,尿道灼痛,尿频,尿急,干咳,恶心,打嗝,排便异常,排尿困难,昏迷,灼热感,胀气,胃痛,脓疱,腹痛,软组织感染,食欲不振,黏液浓痰|免疫力降低,发烧||支原体感染,UU感染,链球菌感染,HP感染,支原体阳性
其他主要为性传播的疾病,不可归类在他处者|A63|便血|hpv感染,丘疹,菜花样突起||尖锐湿疣,外阴尖锐湿疣,湿疣,外阴假性尖锐湿疣,尖锐湿疣激光
未特指的病毒性脑炎|A86|全身不适,咽喉疼痛,寒战,畏光,眩晕,精神不振,肌肉疼痛,腹痛,颈部僵硬|发烧,嗜睡,头疼||未特指的病毒性脑炎,病毒性脑炎,病毒性脑炎后,病毒性脑膜脑炎,病毒性脑炎痊愈,病毒性脑干脑炎
疱疹病毒[单纯疱疹]感染|B00|乏力,全身不适,呕吐,唇水疱,嗜睡,头晕,头疼,定向障碍,恶心,斑疹,昏迷,水疱,溃疡,牙龈疼,红斑样皮疹,肌肉疼痛,肛门瘙痒,腹股沟痒,食欲不振,黄白色水疱|发烧,口唇疱疹,淋巴结肿大,生殖器疱疹,疱疹||疱疹病毒[单纯疱疹]感染,EB病毒感染,疱疹病毒感染,EBVHLH,疱疹,单纯疱疹病毒感染
水痘|B01|咳血,寒战,感染中毒,斑疹,水痘结痂,胸痛,血疱,表皮下大疱,表皮坏死,食欲不振|丘疹,乏力,发烧,咳嗽,咽喉疼痛,头疼,淋巴结肿大,疱疹,结痂||水痘
其他以皮肤和粘膜损害为特征的病毒性感染,不可归类在他处者|B08|厌食,口唇疱疹,咽喉充血,咽部溃疡,唇水疱,头疼,斑疹,溃疡,痘疮,瘙痒,皮肤水疱,结膜充血,结节,肿块,脓疱,舌龈疼痛,身体不适,面部蝶形红斑|丘疹,发烧,咽喉疼痛,水疱,淋巴结肿大,疱疹||手足口病,疱疹性咽峡炎,幼儿急疹,手足口病痊愈
未特指的以皮肤和粘膜损害为特征的病毒性感染|B09|咽喉疼痛,流鼻涕,高烧|丘疹,发烧,水疱,淋巴结肿大,疱疹,触痛||病毒性皮疹,病毒性皮疹,过敏性皮疹
急性乙型肝炎|B16|乏力,发烧,巩膜黄染,恶心,皮肤发黄,肝区疼痛,肝脾肿大,腹胀,蜘蛛痣,食欲不振|乙肝,面部发黄||急性乙型肝炎,乙肝,乙肝大三阳,乙型病毒性肝炎,乙肝携带,病毒性乙肝
巨细胞病毒病|B25|乏力,呼吸困难,咳嗽,啰音,小头畸形,干咳,抽搐,昏迷,智力发育迟缓,皮肤发黄,运动障碍|发烧,皮肤瘀点,肝脾肿大||巨细胞病毒病,巨细胞病毒感染,巨细胞病毒性肝炎,巨细胞病毒肝炎,巨细胞感染,CMV感染
传染性单核细胞增多症|B27|发烧,咽喉疼痛,皮疹,肝区肿大|扁桃体肿大,淋巴结肿大,脾肿大||传染性单核细胞增多症,传单,传染性单核细胞增多症,传染性单核细胞增多,传染性单核细胞增多症痊愈,传染性单核细胞增生症
未特指部位的病毒性感染|B34|关节酸痛,发烧,口周疱疹,吞咽困难,吞咽疼痛,呕吐,咳嗽,咽喉疼痛,唾液腺肿大,头疼,恶心,手上水泡,流鼻涕,淋巴结肿大,畏寒,疱疹,眼睛发红,眼睛疼痛,红斑样皮疹,肌肉疼痛,肌肉酸痛,肝脾肿大,脚长水泡,脾肿大,腮腺肿大,腹泻,腹痛,面部疼痛,食欲不振,黏膜损害|||病毒性感染,病毒感染,轮状病毒感染,乙肝病毒感染,病毒感染痊愈,病毒感染后指甲脱落
念珠菌病|B37|丘疹,外阴灼痛,外阴糜烂,外阴红肿,水疱,腹股沟红斑,阴道分泌物增多,鳞屑性皮疹|外阴瘙痒,尿道灼痛,性交疼痛,白带增多,豆腐渣样白带||念珠菌病,VVC,RVVC,VVC治疗中,bv,尖锐湿疣
卡波西肉瘤|C46|体温升高,发烧,皮肤肿块,间歇性疼痛|体表肿块||卡波西肉瘤,EWS,RMS,横纹肌肉瘤,尤文肉瘤
乳房恶性肿瘤|C50|乳头内陷,乳头灼痛,乳头瘙痒,乳头糜烂|乳头溢液,乳房包块,皮肤点状凹陷||乳房恶性肿瘤,乳腺癌,乳癌,乳腺Ca,乳腺ca,乳腺CA
宫颈恶性肿瘤|C53|尿急,尿道灼痛,尿频,白带异常,尿血,阴道分泌物增多|阴道不规则出血||宫颈恶性肿瘤,宫颈癌,宫颈Ca,宫颈CA,宫颈ca,宫颈癌Ib
子宫体恶性肿瘤|C54|子宫出血,尿道灼痛,性交疼痛,排尿困难,盆腔坠痛,阴道分泌物增多|脓性分泌物,腹痛,腹部包块,阴道不规则出血||子宫体恶性肿瘤,子宫内膜癌,宫内膜癌,子宫内膜Ca,内膜Ca,宫内膜Ca
卵巢恶性肿瘤|C56|子宫不规则出血,绝经后出血,胀痛,身体消瘦|月经不调,腹痛,腹腔积液,腹部包块||卵巢恶性肿瘤,畸胎瘤,卵巢Ca,左卵巢畸胎瘤,右卵巢畸胎瘤,卵巢畸胎瘤
女性生殖器官其他和未特指的恶性肿瘤|C57|发烧,衰弱,食欲不振|下腹肿块,腹痛,阴道流血||卵巢恶性肿瘤,输卵管恶性肿瘤,右输卵管恶性肿瘤
肾(除外肾盂)恶性肿瘤|C64|咳血,头疼,精神不振,腹部不对称,腹部肿大,身体消瘦|腰疼,腹部包块,尿血||肾恶性肿瘤,WT,肾母细胞瘤,右肾母细胞瘤,肾母细胞瘤化疗
未特指细胞类型的白血病|C95|丘疹,乏力,体重下降,全身不适,关节酸痛,内脏出血,发烧,呼吸困难,咳嗽,四肢无力,头晕,头疼,心慌气短,感染,溃疡,白细胞增多,皮肤斑丘疹,皮肤瘀点,盗汗,纵隔增宽腹胀,纵隔病变,结节,继发感染,胸闷气短,血小板减少,血细胞减少,表情淡漠,视力改变,视网膜出血,颈部僵硬,食欲不振,高烧|淋巴结肿大,牙龈出血,肝脾肿大,胸骨疼痛,脾肿大,面色苍白,骨痛||白血病,ALL,ALLL,AMLM,APL,急性白血病
宫颈原位癌|D06|小腹疼痛,腰疼|尿频,尿急,排尿疼痛,阴道不规则出血,阴道分泌物增多||宫颈原位癌,CIN,CINI,CINIII,宫颈CIN,CINII
血管瘤和淋巴管瘤,任何部位|D18|丘疹,偏瘫,吞咽困难,呼吸困难,嘴唇偏大,头疼,截瘫,抽搐,瘙痒,结节,肝脾肿大,脊椎僵直,脑室出血,腹部包块,血管杂音,软组织肥大,颅内压增高,颈部僵硬,食欲不振|红斑样皮疹,血管畸形,血管痣||血管瘤和淋巴管瘤,任何部位,血管瘤,皮肤血管瘤,背部血管瘤,淋巴管瘤,颅咽管瘤
子宫平滑肌瘤|D25|子宫出血,无宫缩,脓血性白带,阴道不规则出血,阴道分泌物增多|尿急,尿频,月经量多,白带增多,腰背疼,腹痛,腹部包块||子宫平滑肌瘤,子宫肌瘤,多发性子宫肌瘤,子宫肌瘤挖除,子宫肌瘤剥除,子宫肌瘤切除
女性生殖器官动态未定或动态未知的肿瘤|D39|咳血,子宫出血,子宫增大,子宫肿块,尿道灼痛,尿频,心慌气短,性交困难,恶心,气短,结节,食欲不振|接触性出血,腹痛,腹部包块,阴道不规则出血,阴道米汤样排液||卵巢肿瘤,子宫肿瘤,侵袭性葡萄胎,子宫内膜间质肿瘤,卵巢混合性生殖细胞肿瘤
其他贫血|D64|上肢水肿,便血,出血,厌食,发绀,吐血,吞咽困难,呼吸困难,咳血,咽喉不适,四肢无力,四肢畸形,大便干结,失血,头晕,寒战,小便困难,尿少,尿色浑浊,心动过速,心率过快,指甲变形,新生儿贫血,无力,毛发稀少,气短,水肿,淋巴液流出,牙龈出血,牙龈发白,生长发育缓慢,畏寒,皮肤发红,皮肤干燥,目光呆滞,眼前发黑,眼白发青,眼花,神经痛,红细胞增多,结节,肌肉疼痛,肝淤血,胃酸减少,背疼,胸痛,胸骨疼痛,脉搏加速,脓疱,腹痛,腹胀呃逆,腹部包块,舌痛,舌粘膜发炎,血压低,记忆力障碍,身体消瘦,过敏,面色苍白,面部浮肿|乏力,乏力寒战,关节酸痛,发烧,呕吐,巩膜黄染,心慌气短,恶心,手脚冰凉,气血虚弱,皮肤发白,皮肤发黄,眩晕,肝脾肿大,脾肿大,蛋白尿,血细胞减少,贫血,食欲不振||贫血,缺铁性贫血,地中海贫血,地贫,AA
遗传性因子Ⅶ缺乏|D66||便血,关节酸痛,牙龈出血,皮肤出血,鼻出血||遗传性因子Ⅶ缺乏,血友病甲,血友病乙,血友病,重型血友病甲,血友病B
其他凝血缺陷|D68|伤口不愈|牙龈出血,紫癜||其他凝血缺陷,凝血功能异常,凝血功能障碍,抗心磷脂抗体阳性,希特林蛋白缺乏症,抗心磷脂抗体
紫癜和其他出血性情况|D69|便血,关节肿胀,内脏出血,出血,发绀,呕吐,咽喉疼痛,头疼,尿血,恶心,斑疹,水肿,溃疡,畏寒,皮肤发紫,皮肤瘙痒,眼眶瘀斑,肾脏受累,胸痛,脓疱,腹泻,蛋白尿,血压高,鼻出血|关节酸痛,发烧,牙龈出血,瘙痒,皮肤出血,皮肤瘀点,紫癜,腹痛,血小板减少||紫癜,过敏性紫癜,HSP,HSPN,ITP,紫癜性肾炎
粒细胞缺乏|D70|下肢沉重,失眠多梦,头晕,白细胞减少|感染,粒细胞减少||粒细胞缺乏,粒细胞缺乏症,粒细胞减少,粒细胞减少症,粒细胞缺乏,粒细胞降低
其他白细胞疾患|D72|代谢紊乱,失血,恶性肿瘤,白细胞增多,组织坏死|乏力,关节酸痛,发烧,感染||白细胞增高,嗜酸细胞增多症,白细胞减少,嗜酸细胞增高,白细胞降低
血液和造血器官的其他疾病|D75|乏力,代谢异常,发烧,头疼,淋巴结肿大,焦虑,皮肤发红,红细胞增多,血压高|发绀,高原多血面容||血液疾病,造血器官疾病,血小板增高,血小板增多症,血小板增多,原发性血小板增多症,血小板升高
与淋巴网状组织和网状组织细胞系统的某些疾病|D76|牙槽前突,突眼,紫癜,结痂,结节,肉芽肿,脊髓压迫,长骨肿胀|淋巴结肿大,皮疹,肝脾肿大||LCH,HLH,噬血细胞综合征,嗜血细胞综合征,嗜血细胞综合症
碘缺乏相关性甲状腺疾患和有关情况|E01|吞咽困难,呼吸困难,咳嗽,声音嘶哑|甲状腺肿大||碘缺乏,甲低,甲亢,甲减,暂时性甲低,甲状腺功能低下
其他非毒性甲状腺肿|E04|压迫感,吞咽困难,呼吸困难,咳嗽,喘鸣,声音嘶哑,结节样变|甲状腺肿大,颈部肿大||甲状腺肿大,甲状腺结节,GD,甲状腺囊肿,甲状腺肿
甲状腺毒症[甲状腺功能亢进症]|E05|乏力,出汗,呕吐,呼吸困难,心率过快,恶心,意识混乱,昏迷,气短,腹泻,血管杂音,躁动,颤抖|发烧,多汗,心慌气短,激动,甲状腺肿大,结节,身体消瘦|甲状腺功能亢进,突眼|甲状腺毒症,甲状腺功能亢进症,甲功异常,TS,高TSH血症,低TSH血症,低FT
甲状腺炎|E06|乏力,体重下降,吞咽困难,呼吸困难,咽喉疼痛,头疼,寒战,月经不调,气短,皮肤干燥,突眼,结节,脓疱,腹胀,身体消瘦,麻痹|发烧,声音嘶哑,心慌气短,性欲减退,甲状腺功能亢进,甲状腺功能亢进面容,甲状腺肿大,畏寒,皮肤瘙痒||甲状腺炎,CLT,桥甲炎,乔甲炎,甲状腺炎,桥本氏甲状腺炎
甲状腺的其他疾患|E07|吞咽困难,声音嘶哑,甲状腺肿大,骨龄延迟|智力发育迟缓,甲状腺功能低下,眼睑浮肿,表情淡漠||甲状腺疾病,低T
未特指的糖尿病|E14|皮肤干燥,肌肉萎缩,视力改变,视网膜出血,视网膜水肿,视网膜脱离,足底溃疡,间歇性跛行|体重下降,多尿,多食,多饮||糖尿病,I型糖尿病,II型糖尿病,型糖尿病
胰腺内分泌的其他疾患|E16|听力减退,嗜睡,四肢无力,心慌气短,心率不齐,焦虑,缺血性挛缩,血压高|糖尿病,肥胖||高INS血症,高胰岛素血症,胰岛素抵抗,低血糖
垂体功能亢进|E22|乏力,厌食,呕吐,嗜睡,多尿,多饮,头疼,恶心,昏睡,昏迷,溢乳,生长激素分泌过多,甲状腺肿大,皮肤粗糙,背疼,舌体肥大,身材矮小,静脉压偏高,食欲不振,鼻端肥大|性早熟,身材发育异常||垂体功能亢进,CPP,中枢性性早熟,CP,CPP追高,高PRL血症
垂体功能减退和其他疾患|E23|乏力,出血疹,发烧,呕吐,嗜睡,多尿,头疼,容貌娇小,尿频,恶心,昏迷,毛发稀少,烦渴多饮,生长激素分泌过少,甲状腺功能低下,皮肤干燥,眼睑下垂,肥胖,血压高,视力改变,视野缺损|生长发育缓慢,身材矮小||垂体功能减退和其他疾患,PGHD,GHD,部分生长激素缺乏症,生长激素缺乏症,下丘脑闭经
卵巢功能障碍|E28|下身肥胖,潮红|四肢红斑,多梦,心慌气短,性欲减退,手脚冰凉,月经不调,月经量少,紧张||卵巢功能障碍,PCOS,POF,卵巢功能低下,卵巢储备功能低下,卵巢早衰
青春期疾患,不可归类在他处者|E30|成人体味,皮下脂肪减少,皮质素不足,腋毛生长过快,身材矮小,阴道不规则出血,阴道分泌物增多,骨骺提前闭合,骨龄延迟|生长发育缓慢,胸部发育缓慢,阴毛早发育||青春期疾患,,乳房早发育,青春期追高,性早熟,青春期,小青春
其他内分泌疾患|E34|乏力,体型异常,发烧,呼吸困难,头晕,心慌气短,毛发灰白,气短,皮肤发红,皮肤老化,肌肉萎缩,肿胀,腹泻,腹痛,腹胀,面部发红,颈部潮红,鸟嘴样尖鼻|身材矮小||内分泌疾患,矮身材,身材矮小,ISS,偏矮,矮小
营养不良和其他营养缺乏的后遗症|E64|全身水肿,呼吸困难,咽喉疼痛,新生儿抽搐,甲状腺功能低下,皮下脂肪减少,皮肤干燥,肌肉萎缩,膝内翻,膝外翻,食欲不振,骨痛,骨骼突出|O型腿,X型腿,体重下降,出牙延迟,哭闹不安,步态不稳,漏斗胸,生长发育缓慢,肌张力降低,营养不良,身体消瘦,鸡胸||VD不足,佝偻病,VD低水平,早佝,VD正常低水平
肥胖症|E66|体型异常,打呼噜,气短|代谢异常|肥胖|肥胖症,肥胖,超重,单纯性肥胖,肥胖症,单纯肥胖
卟啉和胆红素代谢紊乱|E80|乏力,便秘,刺痛,呕吐,心率过快,意识混乱,毛发异常,溃疡,疤痕,痉挛,瘙痒,皮疹,皮肤发红,皮肤损害,皮肤硬化,肌肉疼痛,腹痛,虚弱,起泡,麻木感|皮肤发黄,皮肤瘙痒,脾肿大||卟啉代谢紊乱,胆红素代谢紊乱,高胆红素血症,重度高胆红素血症,危险性高胆红素血症,高胆红素血症后,家族性高胆红素血症
矿物质代谢紊乱|E83|乏力,双脚刺痛,呕吐,呼吸困难,嘴唇刺痛,四肢抽搐,四肢麻木,多尿,头疼,幻觉,恶心,手指刺痛,抑郁,抽筋,早起僵硬,昏睡,易怒,激动,烦躁,糖尿病,肌无力,肌肉痉挛,肝功能异常,肝脾肿大,腹痛,舌头刺痛,色素沉着,血糖升高,记忆丧失,身体消瘦,食欲不振|代谢紊乱||矿物质代谢紊乱,低钙,肺含铁血黄素沉着症,肺含铁,肝豆状核变性,肺含铁血黄素沉积症
躁狂发作|F30||思维紊乱,注意力不集中,狂躁,睡眠减少,行为冲动,言语迫促,语速增快||躁狂发作,抽动样,腹痛发作性
未特指的精神发育迟缓|F79|体型异常,语言发育迟缓,面部畸型|学习困难,智力发育迟缓,精神发育迟滞||精神发育迟缓,智力低下,MR,交叉擦腿综合征,智力发育落后,智力落后
特定性言语和语言发育障碍|F80|抽搐,焦虑|注意力不集中,语言发育迟缓||特定性言语和语言发育障碍,语言发育落后,语言表达延迟,语言落后,语言发育迟缓,构音障碍
特定性学习技能发育障碍|F81|四肢麻木,情绪障碍,神经痛,肌肉痉挛,肌肉萎缩|学习困难,注意力不集中,认知功能障碍||学习障碍,学习困难
弥漫性[综合性]发育障碍|F84|兴趣狭窄,刻板严肃|交流障碍,喜欢独处,孤独症,社交障碍,自闭,表情淡漠,语言发育迟缓||弥漫性发育障碍,孤独症,自闭症,孤独症谱系障碍,孤独症广泛发育障碍,孤独症倾向
多动性障碍|F90||学习困难,注意力不集中,行为冲动||多动性障碍,ADHD,多动症,多动,好动,多动倾向
抽动障碍|F95|咽喉疼痛,强迫行为,抽搐,摇头转颈,激动,肌肉痉挛|不自主运动,四肢抽搐,面部肌肉抽动||抽动障碍,抽动症,抽搐,抽动,抽动障碍,嘴角抽动
通常在童年和青少年期发病的其他行为和情绪障碍|F98|厌奶,尿流缓慢,尿频,尿急,膀胱充盈|偏食,口吃,尿失禁,尿床,挑食,遗尿||情绪障碍,遗尿症,遗尿,厌奶,挑食,偏食
细菌性脑膜炎,不可归类在他处者|G00|听力减退,呼吸困难,昏迷,瞳孔异常|发烧,嗜睡,头疼,寒战,抽搐,烦躁||细菌性脑膜炎,不可归类在他处者,细菌性脑膜炎,化脓性脑膜炎,化脓性脑膜炎后,隐球菌脑膜炎,化脓性脑膜炎痊愈
脑炎、脊髓炎和脑脊髓炎|G04|出血疹,惊厥,昏迷,高烧|发烧,呕吐,嗜睡,头晕,头疼,恶心,意识混乱,烦躁,颈部僵硬||脑炎、脊髓炎和脑脊髓炎,脑炎,急性播散性脑脊髓炎,自体免疫性脑炎,脊髓炎,脑干脑炎
张力失常|G24|吞咽困难,呕吐,强迫性人格,恶心,惊醒,牙关紧闭,眼睑痉挛,肌张力不良,颤抖|不自主运动,肌肉痉挛,舞蹈样动作,运动障碍,颈部僵硬||张力失常,肌张力增高,运动障碍,肌张力降低,下肢肌张力增高,四肢肌张力增高
癫癎[癫痫]|G40|咀嚼困难,咽喉疼痛,多汗,幻听,心慌气短,思维紊乱,恐惧,智力发育迟缓,烦躁,眩晕,眼睛偏斜,腹痛,记忆丧失,语言发育迟缓|意识丧失,意识混乱,智力发育迟缓,肌肉痉挛|癫痫发作|癫癎,癫痫,发作性症状,EP,痫性发作,婴儿痉挛症
偏头痛|G43|出汗,大脑出血,畏光,畏声,高血压|呕吐,头疼,恶心,眼眶疼痛|偏头痛|偏头痛
其他头痛综合征|G44|出汗,面色苍白|呕吐,头晕,头疼,恶心||头痛综合征,发作性头痛,血管性头痛,头痛头晕,头晕头痛,发作性头晕头痛
睡眠障碍|G47|乏力,入睡困难,呼吸困难,夜间易醒,头疼,幻听,情绪低落,打呼噜,抑郁,昏睡,易怒,焦虑,眼睑下垂,睡眠性麻痹,精神不振,肌张力降低|嗜睡,噩梦,失眠多梦,注意力不集中,睡眠障碍||睡眠障碍,睡眠不良,睡眠障碍,睡眠差,发作性头晕,睡眠启动相关障碍
神经疾患|G51|伸舌偏斜,偏瘫,失语,眼皮易跳,面部肌肉抽动,面颊歪斜,颜面肥大|口眼歪斜,口角歪,感觉障碍,眼睑痉挛,鼻唇沟变浅||神经疾患,右侧面瘫,左侧面瘫,面瘫,周围性面瘫,神经皮肤综合征
重症肌无力和其他肌神经疾患|G70|乏力,呕吐,呼吸困难,咀嚼困难,恶心,手臂无力,气短,眼球运动障碍,瞳孔异常,腿部无力,麻痹|口齿不清,吞咽困难,眼外肌无力,肌无力,视力模糊,言语障碍,面肌无力|眼睑下垂|重症肌无力,肌神经疾患,MG,重症肌无力,MG眼肌型,MG眼肌性,肌无力
肌肉的原发性疾患|G71|易跌,行走缓慢,走路年龄推迟,跌倒后不易爬起|无力,骨骼肌萎缩||肌肉的原发性疾患,进行性肌营养不良,肌营养不良,先天性肌营养不良,杜兴氏肌营养不良,先天性肌病
大脑性瘫痪[脑瘫]|G80|大小便失禁,感觉障碍,截瘫,流口水,躯干姿势异常|不自主运动,吞咽困难,步态不稳,肢体瘫痪,舞蹈样动作,言语障碍||大脑性瘫痪,脑瘫,脑发育不良,脑性瘫痪
偏瘫|G81|偏瘫,手指僵硬|口角歪,头眼偏斜,肌张力增高||偏瘫,右侧偏瘫,左侧偏瘫,右侧轻偏瘫,小儿交替性偏瘫
脑积水|G91|喂养困难,情感淡漠,惊跳,意识丧失,昏迷,激动,耳廓红肿,视力改变,颅内压增高,鼓膜充血|呕吐,头疼,头颅增大,恶心,情绪不稳,抽搐,易醒,步态不稳||脑积水,双积水,右积水,积水,梗阻性脑积水
脑的其他疾患|G93|下肢无力,乏力,发烧,呼吸困难,嗜睡,头晕,心动过速,心慌气短,截瘫步态,无力,昏睡,昏迷,步态不稳,烦躁,癫痫发作,眼睛干涩,瞳孔异常,短头畸形,精神不振,耳道流脓,腕部疼痛,腭部出血,血压低,血压波动大,记忆力障碍,震颤,面部发红,颅脑损伤,颈椎增生,颈部疼痛|呕吐,头疼,恶心,意识混乱,肌张力降低||HIE,缺氧缺血性脑病,蛛网膜囊肿,缺血缺氧性脑病,脑软化
眼睑的其他疾患|H02|眼睑红肿|眼睑下垂,眼睑浮肿||眼睑下垂,双眼睑下垂,眼睑麦粒肿,眼睑红肿,眼睑肿胀
泪器系疾患|H04|乏力,发烧,口干舌燥,味觉减退,泪腺发炎,泪腺囊肿,泪腺肿大,皮肤干燥,眼睛干涩,眼睛疼痛,结膜异物|结膜充血||泪器系疾患,鼻泪管堵塞,鼻泪管阻塞,泪囊堵塞,鼻内管堵塞,泪囊炎
结膜炎|H10|两眼干涩,眼睑浮肿,眼睑痉挛,眼睛疲劳,眼睛疼痛,眼睛瘙痒,结膜异物,脓性分泌物,视力改变|流泪,畏光,眼屎多,眼睛不适|结膜充血|结膜炎,过敏性结膜炎,左眼结膜炎,右眼结膜炎,急性结膜炎
其他视网膜疾患|H35|假性近视,水肿,疣状增生,眼前发黑,眼底出血,眼底病变,眼底红斑,眼睛发红,眼睛疼痛,背痛,腹痛,腹部痉挛,色觉异常,虹视,视力改变,视野缺损,说话不清|夜盲,视力模糊,视物变形,视网膜出血,视网膜水肿,视网膜脱离,视野障碍||视网膜疾患,眼底筛查,新生儿眼底筛查,眼底检查,早产儿筛查,早产儿视网膜病变
化脓性和未特指的中耳炎|H66|听力减退,耳内闭塞,耳廓红肿,耳朵出血,耳朵疼,耳漏,耳鼓膜破裂|咽喉不适,耳内发胀,耳痛,鼓膜充血|耳道流脓|化脓性和未特指的中耳炎,中耳炎,化脓性中耳炎,右耳中耳炎,左化脓性中耳炎,左耳急性化脓性中耳炎
风湿性三尖瓣疾病|I07|呼吸困难,水肿,皮肤湿冷,颈部搏动|乏力,压痛,发烧,右上腹痛,肝区疼痛,肝细胞坏死,食欲不振||风湿性三尖瓣疾病,三尖瓣反流,三尖瓣轻度反流,胎儿三尖瓣反流,三尖瓣少量反流,轻度三尖瓣反流
肺血管的其他疾病|I28|肺部造影异常,胸痛|发绀,呼吸困难,心脏杂音,晕厥||肺血管的其他疾病,PS,肺动脉狭窄,PS介入,重度PS,PS扩张
肺动脉瓣疾患|I37|头晕,心律不齐,昏迷,耐力差,肝脏肿大|下肢水肿,乏力,嘴唇发青,心率过快,气短||肺动脉瓣疾患,肺动脉瓣狭窄,肺动脉瓣狭窄球囊扩张,肺动脉瓣狭窄介入,重度肺动脉瓣狭窄,肺动脉瓣重度狭窄介入
心肌病|I42|下肢水肿,头晕,心动过速,心脏杂音,昏迷,气短,肝脾肿大,胸痛,胸闷气短,血压低|乏力,发烧,呼吸困难,咽喉疼痛,心慌气短,肌肉酸痛||心肌病,心内膜弹力纤维增生症,心弹纤,心肌致密化不全,心肌病,心肌损伤
其他心律失常|I49|呕吐,咳嗽,四肢麻木,大脑缺血,头疼,心室颤动,心率过快,恶心,意识丧失,抽搐,无力,昏迷,暴饮暴食,烦躁,焦虑,眼前发黑,瞳孔异常,紧张,胸口紧迫感,胸痛,虚弱,血压低,面色青紫|乏力,传导阻滞,呼吸困难,头晕,心动过缓,心动过速,心慌气短,心率不齐,气短,胸闷气短||心律失常,室性早搏,频发室早,房性早搏,阵发性室上性心动过速
心力衰竭|I50|喘息,意识混乱,濒死感,皮肤湿冷|下肢水肿,呼吸困难,咳嗽,泡沫样痰||心力衰竭,肌酶增高,心肌酶增高,心肌损害,CK增高,心力衰竭
心脏病的并发症和不明确表述|I51|体重下降,健忘,发烧,呕吐,咳嗽,头晕,头疼,心率不齐,恶心,指甲发紫,收缩期杂音,甲状腺功能亢进面容,肺淤血,腹痛,腹胀,腿脚浮肿,血压低,身体消瘦,食欲不振|乏力,呼吸困难,心动过速,心慌气短,心脏肥大,气短,皮肤发紫,肝脾肿大,胸痛,胸闷气短||心脏病的并发症,心肌炎,心包心肌炎,心肌疾病,心脏扩大,心脏增大
其他非创伤性颅内出血|I62|偏瘫,头皮血肿,瞳孔异常,遗尿|呕吐,头晕,头疼,恶心,烦躁,颅内压增高||颅内出血,颅内出血引流,早产儿颅内出血,新生颅内出血,颅内血肿
其他周围血管疾病|I73|手指发紫,手臂刺痛,指甲变形,溃疡,皮肤发白,皮肤发红,肿胀,间歇性跛行|发凉,四肢发冷,皮肤发紫,麻木感||血管疾病,跛行,右下肢跛行,右脚跛行,右腿跛行,间歇性跛行
静脉的其他疾患|I87|体形瘦弱,左腹疼痛|蛋白尿,尿血||胡桃夹综合征,左肾静脉压迫综合征,胡桃夹综合症,左肾静脉胡桃夹综合征,左肾静脉胡桃夹综合症
非特异性淋巴结炎|I88|淋巴结疼痛,脓疱|压痛,发烧,咽喉疼痛,淋巴结肿大,腹痛||非特异性淋巴结炎,肠系膜淋巴结炎,颈部淋巴结炎,颈淋巴结炎,淋巴结炎,颌下淋巴结炎
多发性和未特指部位的急性上呼吸道感染|J06|乏力,倦怠,口干舌燥,吞咽困难,呼吸急促,咳嗽,咽喉灼热,咽部溃疡,喉咙疼,感冒,扁桃体发炎,淋巴结肿大,畏寒,眼睛疼痛,舌苔黄,颈部肿大,食欲不振,鼻痒,鼻脓涕有臭味|发烧,吞咽疼痛,呼吸困难,咳嗽,鼻涕,咳痰,咽喉疼痛,声音嘶哑,失语,头疼,扁桃体肿大,打喷嚏,流鼻涕,肌肉疼痛,鼻塞||急性上呼吸道感染,上感,急性扁桃体炎,急性化脓性扁桃体炎,扁桃体炎
流行性感冒,病毒未标明|J11|乏力,发烧,呕吐,呼吸急促,咳嗽,咽喉疼痛,头疼,干咳,畏寒,皮肤发紫,肌肉酸痛,腹泻,腹痛,食欲不振,鼻塞|脓性痰,血痰||流行性感冒,病毒未标明,反复感冒,胃肠型感冒,感冒
肺炎,病原体未特指|J18|乏力,体重下降,全身不适,关节酸痛,出汗,厌食,发绀,呕吐,咽喉不适,咽喉疼痛,头疼,心慌气短,恶心,意识混乱,昏迷,烦躁,畏寒,盗汗,肌肉酸痛,肝脾肿大,肺部感染,胸痛,胸闷气短,脓疱,腹痛,腹胀,血痰,身体消瘦,面色苍白,高烧,鼻塞|发烧,呼吸困难,咳嗽,咳痰,寒战,气短,脓痰||支气管肺炎,肺炎,喘息性肺炎,喘息性支气管肺炎,支原体肺炎
慢性鼻炎、鼻咽炎和咽炎|J31|咳嗽,喉部堵塞,头疼,恶心,灼热,鼻内发痒,鼻孔干疼,鼻屎多,鼻毛脱落,鼻腔干燥,鼻腔结痂|吞咽疼痛,咽喉不适,咽喉充血,打喷嚏,流鼻涕,鼻塞,鼻痒,鼻粘膜干燥,鼻粘膜肿胀||慢性鼻炎、鼻咽炎和咽炎,鼻炎,过敏性鼻炎,AR,慢性咽炎,慢性咽喉炎
扁桃体和腺样体慢性疾病|J35|下颌疼,乏力,发烧,口臭,吞咽困难,呛咳,咳嗽,喉咙疼,声音嘶哑,头疼,打呼噜,气短,耳朵疼,耳鸣,胸闷气短|听力减退,咽喉不适,咽喉疼痛,扁桃体发炎,扁桃体肿大,耳闷||反复扁桃体炎,慢性扁桃体炎,腺样体肥大,扁桃体肥大,腺样体增生
支气管炎,未特指为急性或慢性|J40|乏力,压痛,口干舌燥,吞咽困难,呼吸困难,咯痰,咳嗽,发烧,咽喉不适,咽喉充血,喉咙肿,心率过快,气短,淋巴结肿大,深黄色浓痰,烦躁,痰中带脓,皮肤发紫,肌肉疼痛,肌肉痉挛,背疼,胸痛,脓性分泌物,脓疱,进食困难|发烧,呼吸急促,咳嗽,咳痰,咽喉疼痛,声音嘶哑,寒战,流鼻涕,肌肉酸痛,黏液浓痰,鼻塞,鼻翼煽动||支气管炎,喘息性支气管炎,喘支炎,喉气管－支气管炎,毛细支气管炎
哮喘|J45|上腹疼痛,发烧,发音改变,呕吐,呼吸微弱,咳痰,喉鸣,喘息,嗜睡,干咳,心率过快,恶心,气短,流鼻涕,皮肤发紫,皮肤瘙痒,睡觉多汗,神志不清,结膜充血,胸痛,脸色乌青,腹痛,身体消瘦,过敏,颜面潮红,鼻出血,鼻塞|呼吸困难,咳嗽,哮鸣音,打喷嚏,胸闷气短||哮喘,哮喘,CVA,支气管哮喘,咳嗽变异性哮喘,哮喘发作
其他间质性肺疾病|J84|厌食,四肢关节痛,黏液浓痰|呼吸急促,皮肤发紫,身体消瘦||间质性肺炎,间质性肺病,毛细支气管炎肺炎
其他呼吸性疾患|J98|发绀,吞咽困难,吸气困难,呕吐,咳血,头晕,头疼,寒战,心动过速,恶心,昏迷,气短,水肿,烦躁,痰中带臭,皮肤发紫,耳痛,胸闷气短,腹痛,腹胀,虚弱,血压低,身体消瘦|发烧,呼吸困难,咳嗽,咳痰,胸痛||肺部感染,支气管,喘息性支气管,支气管软化,弥漫性肺疾病
牙发育和出牙疾患|K00||出牙延迟,牙釉质腐蚀,牙齿斑块,磨牙||牙发育和出牙疾患,磨牙,出牙延迟,萌牙延迟,出牙迟缓,出牙缓慢
龈炎和牙周疾病|K05|口臭,牙齿缝隙大,牙齿黑斑,牙龈发红,牙龈疼,齿龈肿痛,齿龈肿胀|牙龈出血,牙龈发肿,牙龈溢脓||龈炎,牙周疾病,牙龈炎,牙龈脓肿,牙周炎,右下牙龈炎
口区囊肿,不可归类在他处者|K09||压迫感||皮样囊肿,囊肿,眉弓囊肿,牙龈囊肿,左眉梢囊肿
涎腺疾病|K11|伸舌偏斜,压痛,口干舌燥,味觉减退,囊性肿块,脉搏加速,舌体肥大,舌粘膜发炎|张口困难,胀痛,脓性分泌物,腮腺肿大,颌下腺疼痛,颌下腺肿胀||涎腺疾病,腮腺炎,化脓性腮腺炎,左侧腮腺炎,右侧腮腺炎,复发性腮腺炎
唇及口腔粘膜的其他疾病|K13|上唇肥厚,下唇肿胀,发烧,口周疱疹,口唇充血,口腔充血,口角软化,吞咽困难,听力减退,呼吸困难,唇干裂,声音嘶哑,头疼,张口困难,张嘴颌骨响,水肿,牙齿小而稀疏,皮肤干燥,皮肤溃疡,眼睑浮肿,睑裂狭小,粘膜充血,结膜充血,结节,脓疱,舌头白斑,舌粘膜发炎,表皮角化,说话带鼻音,进食困难,食欲不振,食物返流至鼻腔,黏膜损害|压痛,口唇干燥,口唇皲裂,口腔溃疡,口腔痛,唇水疱,溃疡,结痂,颌下淋巴结肿大||唇及口腔粘膜的其他疾病,疱疹性口腔炎,溃疡性口腔炎,口腔炎,口腔溃疡,口角炎
舌疾病|K14|刺痛,溃疡,舌头红斑,舌粘膜发炎|发音困难,咽喉不适,圆形红斑,舌头发胀||舌疾病,地图舌,舌炎,舌尖溃疡,乳头炎,舌面发黑
胃-食管反流性疾病|K21|反酸,吞咽疼痛,呛咳,窒息|恶心,烧心,胃食管反流,胸痛,胸骨疼痛||胃食道反流,胃食管反流,胃食管返流,胃食管轻度反流,贲门松弛
胃炎和十二指肠炎|K29|上腹不适,上腹部痉挛,乏力,体重下降,压痛,厌食,口苦,吐血,吞咽困难,吞咽疼痛,寒战,烧心,稀便,绞痛,胀痛,胃痉挛,胃痛,胃部隐痛,胃酸减少,胆汁返流,胸骨疼痛,腹泻,腹痛,身体消瘦,进食困难|上腹疼痛,发烧,呕吐,恶心,胃粘膜充血,腹胀,食欲不振||十二指肠炎,慢性非萎缩性胃炎,胃炎,急性胃炎,胆汁反流性胃炎,慢性非萎缩性胃窦炎
消化不良|K30|上腹疼痛,厌食,胀气,饱胀|上腹胀,恶心,胃痛,食欲不振||消化不良,纳差,消化功能紊乱
未特指的阑尾炎|K37|皮肤过敏,腹肌紧张|发烧,呕吐,恶心,脐周疼痛,阑尾炎|右下腹痛|阑尾炎
腹股沟疝|K40|便秘,压痛,口唇发麻,呕吐,呼吸困难,呼吸急促,咳嗽,坠胀感,尿急,尿频,恶心,排便困难,粪便量少,结肠偏大,胀痛,胃肠气胀,胸痛,胸骨隆凸,腰疼,腰背疼,腹痛,腹股沟疼痛,腹股沟肿块,腹胀,臀部疼痛,隐痛,食欲不振||腹部包块|腹股沟疝,右侧腹股沟斜疝,左侧腹股沟斜疝,腹股沟斜疝,腹股沟疝,双侧腹股沟斜疝
脐疝|K42|发烧,呕吐,哭闹不安,肚脐周围肿胀,脐突,脐部肿物脱出,腹痛|脐部包块||脐疝,疝气,右侧脐疝
其他非感染性胃肠炎和结肠贺|K52|体重下降,便血,压痛,口唇泛黑,右上腹痛,四肢发冷,寒战,排便异常,水肿,泡沫样稀便,溃疡,粪便量多,肚脐疼痛,肠痉挛,胃肠道功能不好,腰部酸胀,食欲不振,黏液便,黑便,黑便带血|乏力,发烧,呕吐,恶心,肠鸣音,腹泻,腹痛,腹胀||其他非感染性胃肠炎和结肠贺,腹泻,肠炎,急性胃肠炎,迁延性腹泻,急性肠炎
麻痹性肠梗阻和不伴有疝的肠梗阻|K56|便秘,便血,发烧,口渴,右上腹痛,右下腹肿块,呼吸困难,心率过快,排便困难,痉挛,粪便中含虫卵,肠梗阻,肠鸣音,肿胀,脓血便,腹泻,腹部包块,腹部肿大,身体消瘦,面色苍白,食欲不振|不排便,不排气,呕吐,恶心,腹痛,腹胀||肠套叠,肠梗阻,乙状结肠冗长,乙状结肠冗长症,不全性肠梗阻
肠易激综合征|K58|下肢疼痛|肠痉挛,腹痛,腹胀||肠易激综合征,肠痉挛
其他功能性肠疾患|K59|便秘,出血,拒食,排便时间长,直肠疼痛,稀便,食欲不振,黑便|便血,呕吐,大便干结,恶心,排便困难,腹痛,腹胀||便秘,肠功能紊乱,菌群失调,巨结肠,功能性便秘
肛门和直肠的其他疾病|K62|不适感,乏力,出血,刺痛,压痛,坐立不安,寒战,排便不尽,排便困难,排便异常,无法控制排便,溃疡,瘙痒,皮肤发红,直肠流粘液,直肠流血,直肠疼痛,组织突出肛门,肛周肿胀,肛旁脓肿,肛门病变,肛门红肿,肛门肿块,肛门裂口,脓疱,腹部痉挛,黑便|便秘,便血,发烧,排便疼痛,肛周疼痛,肛门坠胀,肛门疼痛,肛门肿胀,腹泻||肛裂,肛周脓肿,肛周炎,肛瘘,肛门狭窄
肝衰竭,不可归类在他处者|K72|乏力,厌油,呕吐,浮肿,牙龈出血,腹水,蜘蛛痣,面色苍白,食欲不振|尿色浑浊,恶心,皮肤发黄,鼻出血||肝衰竭,不可归类在他处者,肝功异常,肝功能异常,肝功损害,肝功损伤,肝功受损
消化系统的其他疾病|K92|上腹疼痛,乏力,出冷汗,呼吸急促,大便褐色,头晕,心慌气短,心率过快,排便异常,烦躁,粪样呕吐物,绞痛,肠出血,面色苍白,黏液便|便秘,便血,吐血,消化不良,腹泻,黑便||消化系统疾病,胃肠功能紊乱,血便,大便带血,呕血,消化道出血
脓疱病|L01|丘疹,体温升高,压痛,发烧,淋巴结肿大|斑疹,溃疡,疱疹,瘙痒,皮疹,结痂,脓疱||脓疱病,脓疱疮,新生儿脓疱疮
蜂窝织炎|L03|关节酸痛,压痛,四肢发冷,头疼,寒战,手指刺痛,指甲变形,指甲破裂,皮肤光滑,皮肤红肿,结节,肿胀,脓性分泌物,脓液,脸部疼痛,颌骨膨胀|发烧,淋巴结肿大,畏寒,皮肤发红,脓疱||蜂窝织炎,甲沟炎,左下肢蜂窝组织炎,蜂窝织炎,面颊蜂窝织炎,面部蜂窝织炎
急性淋巴结炎|L04|压痛,发烧|淋巴结疼痛,淋巴结肿大||急性淋巴结炎,颈部淋巴结,化脓性颈部淋巴结炎,双侧颈部淋巴结炎,右侧颈部淋巴结,左耳前急性化脓性淋巴结炎
皮肤和皮下组织其他局部感染|L08|坏疽|毛囊炎,皮肤感染,皮肤疖痈,皮肤疼痛||皮肤和皮下组织其他局部感染,皮肤感染,感染性皮疹,肛周感染,脐部感染,化脓性脐炎
类天疱疮|L12|乏力,体重下降,发烧,口周脓痂,睑内翻,表皮坏死,黏膜损害|丘疹,水疱,瘙痒||类天疱疮,脓疱疹,脓疱疮
尿布皮炎|L22|口腔痛,口腔白斑,口角生疮,哭闹不安,嘴里白色斑块,烦躁,疱疹,皮疹,皮肤发红,皮肤肿胀,红斑样皮疹,肿胀,脓液,脓疱,舌头白斑|丘疹,溃疡,臀部皮肤粗糙发红,臀部红斑||尿布皮炎,尿布疹,预防尿布疹
变应性接触性皮炎|L23|丘疹,流脓,皮肤干燥,皲裂,肿胀|发烧,皮肤发红,皮肤瘙痒||变应性接触性皮炎,过敏性皮炎,接触性皮炎,左侧足背过敏性皮炎
内服物质引起的皮炎|L27||口唇发麻,喉咙疼,嗓子痒,皮疹,皮肤肿胀,误服药物,食物过敏||内服物质引起的皮炎,牛奶蛋白过敏,食物过敏,牛奶过敏,CMPA,牛奶
慢性单纯性苔癣和痒疹|L28|全身潮红,出血,出血疹,口角生疮,外阴瘙痒,性交困难,指甲变形,斑疹,流脓,流血,淋巴结肿大,皮肤湿疹,皮肤灼热,皮肤瘙痒,红斑样皮疹,结节性损害,脓疱,脚趾甲内长,血疱,趾甲凸起,针尖大小丘疹|丘疹,瘙痒,结节,风团||慢性单纯性苔癣,痒疹,丘疹性荨麻疹,外阴慢性单纯性苔藓,慢性单纯性苔藓,外阴硬化型苔藓,外阴苔藓
其他皮炎|L30|关节酸痛,出血疹,发烧,呕吐,咳嗽,嗜睡,多汗,头疼,恶心,手上水泡,斑疹,水疱,淋巴结肿大,溃疡,潮红,疱疹,瘀斑,瘙痒,皮疹,皮肤剥落,皮肤增厚,皮肤干燥,皮肤损害,皮肤水疱,皮肤浸润,皮肤湿疹,皮肤瘙痒,皮肤皲裂,皮肤硬化,眼睑浮肿,紫癜,红绿色盲,结节,肿胀,脓疱,脱屑,腹壁红斑,虚汗,视力改变,视力模糊,视网膜水肿,黏膜损害|丘疹,皮肤发红,皮肤溃疡,皮肤瘀点,眼睑瘙痒,红斑样皮疹,红斑鳞屑||湿疹,虫咬性皮炎,包皮炎,肛周皮炎,皮炎
荨麻疹|L50|丘疹,全身不适,吞咽困难,呼吸困难,打喷嚏,淋巴结肿大,皮肤充血,皮肤发红,皮肤有压痕,皮肤水疱,皮肤瘙痒,红斑样皮疹,食欲不振|乏力,发烧,呕吐,头疼,恶心,瘙痒,红斑,风团||荨麻疹,丘疹样荨麻疹,急性荨麻疹,慢性荨麻疹,丘性性荨麻疹
甲疾患|L60|脚趾红肿,趾甲变薄|指甲破裂,甲板变厚,甲板变薄,甲板无光泽||甲疾患,甲营养不良,趾甲角化不良,甲床营养不良
其他非瘢痕性毛发缺失|L65|丘疹,眉毛稀疏,秃顶,结节,脱发|毛发异常,毛根松动||毛发缺失,脱发,局部脱发,毛发增多,脂溢性脱发,毛发脱落
毛色和毛干异常|L67|白发|毛发异常||毛色异常,毛干异常,白发,头发白
痤疮|L70||丘疹,囊性肿块,白发,粉刺,结节,脓疱,黑头||痤疮,面部痤疮,痤疮,面部及背部痤疮,面部背部痤疮
其他毛囊疾患|L73|干燥结痂|毛发周围丘疹,毛发周围脓疱,脓疱||毛囊疾患,毛囊炎,化脓性毛囊炎,皮脂腺样皮疹,周孕外阴毛囊炎,皮脂腺
色素沉着的其他疾患|L81||咖啡斑,晒斑,毛表皮痣,皮肤色素沉着,老年斑,色素痣,褐青色痣,雀斑,黄褐斑||皮肤色素脱失,皮肤色素沉着,食物性色素沉着,色素沉着,皮肤咖啡牛奶斑
髋关节病|M16|关节变形,关节积液,软骨磨损,髋关节活动受限|一侧腿短,大腿皱褶,臀部皱褶|髋关节不便|髋关节病,先髋
四肢其他后天性变形|M21|内八字,外八字,扁平足,手指偏大,手指偏短,手腕偏短,手腕畸形,腕关节向掌侧移位,腿部畸形|O型腿,X型腿,内翻足,多指,足内翻||四肢其他后天性变形,X型腿,生理性膝内翻,O型腿,生理性膝外翻,内八字
其他关节疾患,不可归类在他处者|M25|乏力,关节僵硬,关节酸痛,吞咽困难,咽喉疼痛,头晕,头疼,指节增粗,溃疡,滑膜发炎,畏寒,白细胞增多,皮肤斑丘疹,肩关节痛,肿胀,背疼,脓疱,腰背疼,腰骶疼痛,色素沉着,踝关节疼痛,间歇性跛行,颞部疼痛,风湿,食欲不振|丘疹,关节肿胀,发烧,淋巴结肿大,皮疹,肌肉疼痛,肝脾肿大,韧带损伤||JIA,幼年特发性关节炎,JRA,类风湿关节炎,类风湿性关节炎
结节性多动脉炎和有关情况|M30|乏力,咽喉充血,水疱,淋巴结肿大,紫癜|发烧,口唇干燥,斑疹,结膜充血,颈部淋巴结肿大||川崎病
系统性红斑狼疮|M32|乏力,关节肿胀,发绀,夜尿增多,溃疡,管型尿,红斑,肌无力,肌肉酸痛,肝脾肿大,间歇性跛行|关节酸痛,发烧,斑疹,甲周红斑,肌肉疼痛,面部蝶形红斑||系统性红斑狼疮,狼疮性肾炎,系统性红斑狼疮,SLE,系统红斑狼疮,狼疮性肾炎IV型
皮多肌炎|M33|体重下降,关节变形,关节酸痛,厌食,发烧,呼吸困难,头疼,斑疹,皮下组织硬结,皮疹,眼睑红斑,肌肉僵硬,肌肉疼痛,说话困难,食欲不振|乏力,吞咽困难,眼睑红肿,肌无力,肌肉压痛,肌肉酸痛||皮多肌炎,皮肌炎,幼年皮肌炎,幼年性皮肌炎,幼年皮肌炎转移性钙化
结缔组织的其他系统性受累|M35||关节酸痛,发烧||结缔组织病,结缔组织疾病,大便干燥,干燥综合征,混合结缔组织病
其他变形性背部病|M43|体型异常,斜颈畸形,颈部疼痛,颈部肿大,颜面畸形|颈部僵硬||变形性背部病,斜颈,习惯性斜颈,肌性斜颈,右侧斜颈,右侧肌性斜颈
背痛|M54|上肢疼痛,下肢麻痛,刺痛,肌肉萎缩,肾气虚,肾阴虚,胀痛,脚无力,腰疼,腰背痛,腰部僵直,腰部压痛,腰部酸胀,腿部无力,臀部疼痛,麻木感|下肢疼痛,背疼,腰背疼,腰骶疼痛||背痛,腰痛,经期腰痛,腰骶部痛,腰腹胀痛
滑膜炎和腱鞘炎|M65|关节出血,发烧,干燥结痂,手指疼痛,手腕疼痛,滑膜发炎,肌损伤,肌肉硬结,肌肉酸痛,肿胀,腱鞘厚化,膝关节肿大,膝及小腿瘀血斑,足踝包块,踝膝关节积液|关节肿胀,关节酸痛||滑膜炎,腱鞘炎,滑膜炎,扳机指,髋关节滑膜炎,腱鞘炎,左侧髋关节滑膜炎
其他软组织疾患,不可归类在他处者|M79|四肢肿胀,神经痛,脂肪萎缩,软组织疾患,风湿|下肢肿胀,肌肉肿胀,腿痛||软组织疾患,不可归类在他处者,腿痛,左下肢肿胀,右下肢肿胀,膝盖痛,下肢肿胀
肌肉骨骼系统和结缔组织的其他后天性变形|M95|不好动,体形瘦弱,吸气困难,呼吸困难,圆形削肩,心慌气短,气短,罐状腹,腹部肿大,颈部前伸|胸廓变形,驼背||肌肉骨骼畸形,漏斗胸,鸡胸,胸廓畸形,先天性漏斗胸,轻度漏斗胸
梗阻性和反流性尿路病|N13|乏力,呕吐,夜尿增多,尿少,尿瘘,恶心,肾部积水,脓性尿,腹泻,蛋白尿,尿血|发烧,尿道灼痛,尿频||梗阻性和反流性尿路病,左肾积水,肾积水,右肾积水,膀胱输尿管反流,双肾积水
慢性肾病|N18|下肢水肿,乏力,呕吐,夜尿增多,尿中含泡沫,尿血,恶心,生长发育缓慢,血压高,血管损害|低热,全身水肿,多尿,尿血,尿少,腰疼,腹痛,蛋白尿,食欲不振||慢性肾病,肾病综合征,IgA肾病,NS,肾病,肾炎
肾小管功能损害所致的疾患|N25|昏迷,智力发育迟缓|多尿,烦渴多饮||肾小管功能损害所致的疾患,肾小管酸中毒,远端肾小管酸中毒,肾性尿崩症,肾功能损害,肾小管酸中毒I型
尿道炎和尿道综合征|N34|分泌物异常,外阴下坠,尿流缓慢,腰疼,腹痛,膀胱湿热|尿急,尿道灼痛,尿道脓性分泌物,尿频,排尿灼烧感||尿道炎,尿道综合征,尿道口炎,尿道炎,尿道综合征,尿道旁腺脓肿,化脓性尿道口炎
泌尿系统的其他疾患|N39|乏力,发烧,嗜睡,多尿,寒战,尿频,焦虑,神经质,肝脾肿大,肾脓肿,胁腹痛,腰疼,腹痛,尿血,贫血,身体消瘦|尿急,尿色浑浊,尿道灼痛,排尿困难,排尿灼烧感,耻骨上方压迫感||尿路感染,压力性尿失禁,张力性尿失禁,尿失禁,无症状性蛋白尿
鞘膜积液和精子囊肿|N43|排尿困难,溃疡,阴囊瘙痒|阴囊肿大||鞘膜积液和精子囊肿,鞘膜积液,右侧睾丸鞘膜积液,右侧鞘膜积液,睾丸鞘膜积液,左侧睾丸鞘膜积液
男性不育症|N46||少精,无精,男性不育,精子质量差,精液异常||男性不育症,不育症,无精症,畸精症,严重少弱精,丈夫少弱精症
阴茎的其他疾患|N48|丘疹,乏力,出血,包皮粘连,发烧,性交困难,脓性分泌物,阴茎水肿|尿道口红肿,阴茎勃起,阴茎疼痛,阴部溃疡,龟头瘙痒||阴茎,包茎,包皮过长,包皮垢,阴茎炎,包皮
乳房炎性疾患|N61|乳头皲裂,胸闷气短|乳头溢液,乳房压痛,乳房发红,乳房胀痛||乳腺包块,乳腺炎,右侧乳房蜂窝组织炎,右侧乳腺炎,乳腺红肿
乳房肥大|N62|触痛|男性乳房发育||乳房肥大,男性青春期乳房发育,男性乳房发育,青春期男性乳房发育,男性乳房长大,男性乳房发育异常
乳房的其他疾患|N64|乳房增大,乳房胀痛|乳房包块||乳房胀痛,乳房痛,乳房疼痛,乳房增大,乳房硬结
其他女性盆腔炎性疾病|N73|下腹坠胀,头疼,寒战,月经不调,月经量多,月经量少,盆腔坠痛,阴道不规则出血,阴道瘙痒,食欲不振|发烧,子宫压痛,宫颈出血,宫颈触痛,性交出血,性交疼痛,白带增多,脓性白带,腰疼,腰骶疼痛,腹痛,输卵管粘连,阴道分泌物增多||宫颈炎,慢性宫颈炎,盆腔炎,宫腔粘连,盆腔包块
前庭大腺[巴多林腺]疾病|N75|外阴下坠,外阴灼痛,性交困难,淋巴结肿大,瘙痒|外阴红肿,尿道灼痛,阴唇肿块||巴多林腺,前庭大腺囊肿,前庭大腺脓肿,前庭大腺炎
阴道和外阴的其他炎症|N76|会阴溃疡,发烧,淋巴结肿大,脓血性白带|外阴瘙痒,白带增多||阴道炎,BV,VVC,外阴瘙痒,外阴炎
子宫内膜异位症|N80|排便疼痛,月经量多,皮肤触痛,结节,腹痛,触痛|不孕,性交疼痛,月经不调,痛经,腹部包块||子宫内膜异位症,子宫腺肌症,巧囊,EMS,盆腔占位,腺肌症
女性生殖器脱垂|N81|便血,尿急,性交疼痛,排便困难,白带增多,直肠疼痛,背疼,脓性分泌物,黏液便|尿频,腰骶疼痛||女性生殖器脱垂,子宫脱垂,POP,阴道前壁膨出,阴道前壁轻度膨出,阴道前后壁膨出
卵巢、输卵管和阔韧带的非炎性疾患|N83|内出血,性交疼痛,排便疼痛,腹胀,骨痛|下腹坠胀,月经不调,腹痛,腹部包块||左附件占位,右附件占位,附件占位,宫腔占位,卵巢癌
宫颈其他非炎性疾患|N88|下腹坠胀,停经,呼吸急促,子宫出血,子宫压痛,子宫较小,宫颈水肿,尿频,性交疼痛,月经不调,月经量多,痛经,白带增多,绝经后出血,脓性分泌物,腰骶疼痛,闭经,阴道坠胀感,阴道异味,阴道瘙痒,骨痛|宫颈闭锁,白带异常,腹痛,阴道不规则出血,阴道分泌物增多||宫颈病变,LEEP,子宫全切,宫颈LEEP,宫颈leep
外阴和会阴的其他非炎性疾患|N90|丘疹,坐立不安,外阴红肿,水肿,脱屑,阴部溃疡|外阴下坠,外阴灼痛,外阴瘙痒,外阴白斑,外阴萎缩,阴道分泌物增多||外阴营养不良,营养不良,外阴白斑,小阴唇粘连,外阴新生物
月经过多、月经频繁和月经不规则|N92|乏力,出血,头晕,头疼,恶心,神经性厌食,食欲不振|月经不调,闭经||月经紊乱,停经,月经量少,月经稀发,继发闭经
其他异常的子宫和阴道出血|N93||宫颈出血,月经不调,阴道不规则出血||阴道出血,阴道流血,同房出血,阴道不规则出血,功血
与女性生殖器官和月经周期有关的疼痛和其他情况|N94|乳腺胀痛,呕吐,外阴萎缩,大腿疼痛,头晕,头疼,性交困难,恶心,痉挛,经期前乳房痛,经期小腹坠痛,经期腰疼,腰疼,腹胀,阴道粘连,阴道裂伤,阴道触痛,骨痛|下腹坠胀,腰骶疼痛|痛经,腹痛|与女性生殖器官和月经周期有关的疼痛和其他情况,痛经,盆腔积液,宫腔积液,同房痛,原发痛经
绝经期和其他围绝经期的疾患|N95|外阴瘙痒,外阴肿胀,头疼,抑郁,排便困难,月经不调,月经量少,白带增多|无月经来潮,潮热,激动,畏寒|绝经|绝经期和其他围绝经期的疾患,围绝经期,老年性阴道炎,绝经后阴道出血,绝经后,绝经后阴道流血
女性不孕症|N97|月经不调,未避孕未孕,闭经||不孕,同居不妊娠,无排卵,输卵管阻塞|女性不孕症,不孕,原发不孕,继发不孕,不孕症,月不孕
异位妊娠|O00|休克|停经,晕厥,腹痛,阴道不规则出血|宫外孕|异位妊娠,宫外孕,宫外孕史,宫外孕保守,切口妊娠,切口妊娠清宫
未特指的流产|O06|休克,免疫力降低,内分泌异常,妊娠呕吐,子宫变软,子宫增大,晕厥,染色体异常,甲状腺功能亢进,胎盘堵于宫颈口,腰背疼,腹痛,营养不良,葡萄胎,阴道不规则出血,阴道流血,阵发性下腹痛||人工流产,手术流产,流产,自然流产,药物流产|流产,RSA,人流,自然流产史,自然流产后,葡萄胎清宫
为已知或可疑胎儿异常和损害给予的孕产妇医疗|O35||先天性心脏病,宫内发育迟缓,羊水异常,胎心异常||为已知或可疑胎儿异常和损害给予的孕产妇医疗,胎儿先心病,胎儿心脏咨询,胎儿咨询,胎儿,胎儿CHD
产力异常|O62||人工流产,剥膜引产,药物流产|引产|产力异常,引产,引产后,宫颈炎月经紊乱,宫颈松弛,畸胎引产
与分娩有关的乳房和哺乳的其他疾患|O92||乳汁浅黄色,闭经|溢乳|溢乳,泌乳,断奶后乳汁分泌,双乳溢乳,轻微溢乳
可归类在他处的孕产妇的传染病和寄生虫病并发于妊娠、分娩和产褥期|O98||丘疹,性交疼痛,疣状增生,表面隆起,阴部瘙痒|hpv感染|妊娠期,分娩期,产褥期,HPV感染,HPV阳性,HPV,hpv感染,宫颈HPV感染
可归类在他处的孕产妇的其他疾病并发于妊娠、分娩和产褥期|O99||子宫不对称,宫外孕,宫角妊娠,生化流产,腹痛,阴道流血||产褥期,宫角妊娠,生化妊娠后,生化妊娠,早期妊娠,妊娠
胎儿生长缓慢和胎儿营养不良|P05|代谢紊乱,吞咽困难,呼吸困难,喂奶困难,外观不匀称,成骨不全,抵抗力弱,指甲变形,皮下脂肪减少,软骨发育不良,适应性差|体重下降,体重偏低,生长发育缓慢,身材矮小|宫内发育迟缓,早产|胎儿生长缓慢,胎儿营养不良,早产儿,低体重,SGA,早产,SGA矮小
头皮产伤|P12||头皮血肿|头皮损伤|头皮产伤,头颅血肿,头颅血肿肌化,左顶部头颅血肿,新生儿头颅血肿,双顶部头颅血肿
先天性肺炎|P23|哭闹不安,拒绝吃奶,精神不振|口吐白沫,口唇发紫,呛奶,呼吸急促|先天性肺炎|先天性肺炎,新生儿肺炎
新生儿细菌性脓毒症|P36|代谢异常,免疫力降低,凝血功能紊乱,器官损害,白细胞增多|发烧,呕吐,呼吸急促,心动过速,肝脏肿大|败血症|新生儿细菌性脓毒症,脓毒症,新生儿败血症,新生儿败血症复查,严重脓毒症,新生儿脓毒症
其他先天性传染病和寄生虫病|P37|哭闹不安,哺乳困难|口腔白斑,拒绝吃奶|鹅口疮|其他先天性传染病和寄生虫病,鹅口疮,先天性结核病,鹅口疮痊愈
新生儿脐炎伴或不伴轻度出血|P38||脐部有分泌物,脐部溢液,脐部红肿变硬|脐炎|脐炎,新生儿脐炎,轻度脐炎
其他和未特指原因所致的新生儿黄疸|P59||代谢异常,婴儿肝炎,巩膜黄染,面部发黄|新生儿黄疸|黄疸,新生儿黄疸,新生儿高胆红素血症,婴儿肝炎综合征,婴儿肝炎,新生儿病理性黄疸
新生儿惊厥|P90||呼吸困难,四肢抽搐,惊厥,抽搐,痉挛,眼睛偏斜|新生儿惊厥|新生儿惊厥,惊厥
新生儿喂养问题|P92||呕吐,喂养困难,喂奶困难,恶心,进食困难|吐奶,拒绝吃奶|新生儿喂养问题,吐奶,母乳喂养,喂养问题,纯母乳喂养
小头畸形|Q02|||小头畸形|小头畸形,小头畸形
脑的其他先天性畸形|Q04||||脑畸形,脑发育异常,巨脑回,无脑回畸形,左侧脑室增宽,双侧侧脑室增宽
大动脉先天性畸形|Q25|乏力,口唇发紫,吞咽困难,吸吮困难,呼吸道感染,咳血,喂奶困难,心动过速,心慌气短,心脏杂音,感冒,无力,晕厥,生长发育缓慢,身体消瘦,面色苍白|体重增长慢,发绀,呼吸急促,咳嗽,心力衰竭,气短|先天性心脏病,动脉导管未闭,卵圆孔未闭,室间隔缺损|大动脉先天性畸形,先心病,CHD,先天性心脏病,卵圆孔未闭,室间隔缺损
喉先天性畸形|Q31|喉鸣|呼吸困难,甲状软骨异常,窒息,软骨异常|喉软骨发育不良|喉先天性畸形,喉软骨发育不良,先天性喉软骨发育不良,先天性喉软骨软化病
肠的其他先天性畸形|Q43|喂奶困难,排便异常|不排便,便秘,呕吐,腹胀|结肠偏大,脐茸|肠的先天性畸形,脐茸,先天性巨结肠,先天巨结肠,先天性无肛,先天性巨结肠手术
女性生殖器的其他先天性畸形|Q52||不孕,先天性子宫发育不良,子宫纵膈,性交困难,月经不调,病理妊娠,纵膈子宫,阴道闭锁||女性生殖器先天性畸形,纵膈子宫,子宫纵膈,双子宫,子宫纵膈切除,不全纵膈子宫
男性生殖器官的其他先天性畸形|Q55|不育,尿道下裂,疝气,睾丸异位,睾丸扭转,输精管畸形,阴囊错位,阴茎下弯,阴茎发育不全|睾丸不全,睾丸偏小,阴茎偏小,阴茎包埋|睾丸发育不良,隐匿阴茎|男性生殖器官先天性畸形,隐匿阴茎,隐睾,右侧隐睾,左侧隐睾,隐匿性阴茎
肾的其他先天性畸形|Q63||呕吐,尿少,恶心,腰部酸胀,腹胀,腹部包块||肾的先天性畸形,双肾尿盐结晶,先天性肾积水,双肾集合部分离,双肾分离,马蹄肾
髋先天性变形|Q65|单脚走路|一侧腿短,体表褶皱,走路有点瘸,髋关节不便,髋关节活动受限,髋关节脱位|髋关节发育不良|髋先天性变形,髋关节发育不良,先天性髋关节脱位,先天性髋关节发育不良,左侧髋关节发育不良,髋关节发育异常
皮肤的其他先天性畸形|Q82||||皮肤先天性畸形,毛细血管瘤,胎记,皮肤毛细血管瘤,外阴色素痣,横纹肌样瘤
乳房先天性畸形|Q83||乳头内陷,乳房不对称,乳房偏小,乳房发育不良||乳房先天性畸形,乳房发育,单纯乳房发育,乳房发育不良,乳房发育差,单侧乳房发育
影响多系统的其他特指先天性畸形综合征|Q87|发育迟缓,癫痫发作,精神运动性障碍|先天面容畸形,眼耳畸形|哭时歪嘴|歪嘴哭综合征,歪嘴哭综合症,左耳畸形咨询,无意识歪嘴,右侧歪嘴哭综合征
特纳综合征[性腺发育障碍症][45,X综合征]|Q96|多痣,手外翻,盾形胸,肘外翻,足背浮肿,颈侧皮肤松弛|体重下降,第二性征发育不良,身材矮小||特纳综合征,性腺发育障碍症,45X综合征,性腺发育不良,单纯性性腺发育不良,特纳综合征,XX单纯性性腺发育不良,XY单纯性腺发育不良
其他染色体异常,不可归类在他处者|Q99||染色体异常||染色体异常,性发育异常,XY单纯性性腺发育不全,性腺发育异常,XY性腺发育不全
心脏搏动异常|R00|心动过缓,心慌气短,昏迷,染色体异常,眩晕,胸痛|心动过速,心率过快||心脏搏动异常,心动过速,心悸,窦性心动过缓,心动过缓,短阵房性心动过速
心脏杂音和其他心音|R01|主动脉杂音|心脏杂音||心脏杂音和其他心音,心脏杂音,生理性杂音,杂音,心脏杂音待排,心脏杂音待查
呼吸道出血|R04|吐血,痰中带血|咳血,鼻出血||呼吸道出血,鼻衄,咯血
咳嗽|R05||咳嗽||咳嗽,慢性咳嗽,感染后咳嗽,变异性咳嗽,慢性咳嗽待查,慢性咳嗽痊愈
呼吸异常|R06|口呼吸,喘息,喘鸣,屏气,打呼噜,打喷嚏,打嗝|呼吸困难||呼吸异常,屏气发作,幼儿喘息,反复喘息,呃逆,婴儿喘息
咽痛和胸痛|R07|咽喉充血,心前区疼痛,胸闷气短|咽喉疼痛,胸痛||胸痛,心前区疼痛,心前区不适,反复胸痛,咽痛
腹部和盆腔痛|R10|上腹疼痛,会阴疼痛|盆腔坠痛,腹痛||腹部痛,盆腔痛,腹痛,下腹痛,下腹不适,上腹痛,外阴痛
恶心和呕吐|R11||呕吐,恶心||呕吐,恶心,干呕,周期性呕吐,头痛呕吐
未特指的黄疸|R17|便秘,呕吐,恶心,皮肤瘙痒,腹泻,腹痛,腹胀,食欲不振|巩膜黄染,皮肤发黄||黄疸,母乳性黄疸,病理性黄疸,生理性黄疸,轻度黄疸
腹水|R18||腹水||腹水,腹水,大量腹水,腹水疑腺癌待查
累及消化系统和腹部的其他症状和体征|R19|便秘,便血,发烧|腹痛,腹部包块||便血,大便干结,腹部包块,腹部不适,排便困难
皮疹和其他非特异性斑疹|R21|发烧,发痒,哭闹不安,斑疹,点状皮疹|丘疹,皮疹||斑疹,过敏性皮疹,皮疹,虫咬性皮疹,反复过敏性皮疹,全身皮疹
其他皮肤改变|R23|下唇瘀斑,巩膜黄染,皮肤发紫,皮肤发黄|发绀,口唇发紫||其他皮肤改变,皮肤黄染,口唇发绀,发绀,口周发绀,指端青紫
异常的步态和移动|R26|偏瘫,剪刀步态,走路姿势异常,走路跛行,醉汉步态,麻痹步态|步态不稳,走路不稳||步态异常,走路姿势异常,步态不稳,走路跛行,走路不稳
与排尿有关的疼痛|R30|排尿困难,排尿疼痛|尿道灼痛,尿频||尿痛,排尿困难,尿频尿痛
未特指的血尿|R31|尿色偏红|尿血||尿血,血尿,反复血尿
多尿|R35|夜尿增多,尿频,糖尿病|多尿,烦渴多饮||多尿,尿频,夜尿多,日间性尿频,尿多
头晕和眩晕|R42|乏力,大脑摇晃,失眠多梦,头胀,头重脚轻,情绪不稳,眼花,耳鸣,面色苍白|头晕,眩晕||头晕,眩晕,头晕
言语障碍,不可归类在他处者|R47|失语,言语障碍,语言发育迟缓|发音困难,表达不清,说话不清||言语障碍,构音不良,语言,构音不清,吐字不清,语言表达不良
其他和原因不明的发热|R50||发烧||发热,发热抽搐,发热皮疹,发热NOS,长期发热
头痛|R51|发烧,呕吐,头晕,恶心|头疼||头痛,头痛,反复发作性头痛
疼痛,不可归类在他处者|R52|上腹疼痛,下肢疼痛,关节酸痛,膝关节疼痛|||疼痛,双下肢疼痛,膝关节疼痛,关节疼痛,下肢疼痛,腰骶部疼痛
晕厥和虚脱|R55|两眼发黑,四肢无力,头晕,视力模糊|恍惚,晕厥,虚脱||晕厥和虚脱,晕厥,血管迷走性晕厥,血管迷走神经性晕厥,血管迷走神经型晕厥,血管迷走性神经晕厥
惊厥,不可归类在他处者|R56|呼吸急促,四肢抽搐,意识丧失,烦躁,眼球上翻,神情惊恐,面部肌肉抽动|惊厥,高烧||惊厥,热性惊厥,复杂性热性惊厥,CFC,高热惊厥,热性惊厥附加症
出血,不可归类在他处者|R58|皮肤瘀点|皮肤出血||出血,皮肤瘀斑,瘀斑,右跖瘀斑,皮肤出血
淋巴结增大|R59|淋巴结疼痛|淋巴结肿大||淋巴结增大,颈部淋巴结长大,颈部淋巴结肿大,淋巴结长大,颈淋巴结长大,耳后淋巴结长大
多汗症|R61|夜间多汗|多汗||多汗症,多汗,多汗症,盗汗,夜间多汗
未达到预期正常生理发育水平|R62|体重下降,头围增长慢,第二性征发育不良,运动发育落后|生长发育缓慢,营养不良,身材矮小||生长发育,生长偏离,运动发育落后,生长迟缓,青春晚期
有关食物和液体摄取的症状和体征|R63|身体消瘦,进食不足,面部发黄|体重异常,厌食,烦渴多饮,食欲不振||厌食,轻度低体重,食欲下降,体重增长差,体重减轻
其他的一般症状和体征|R68|口干舌燥,哭闹不安,心肌炎,手指异常,皮肤发紫,软腭麻痹,阵发性哭闹|声音嘶哑,夜间哭闹||哭闹,夜间哭闹,阵发性哭闹,口干,哭闹发绀
血清酶水平异常|R74|胆汁酸增高|||血清酶水平异常,胆汁酸增高,转氨酶增高,血清酶学增高,神经元特异性烯醇化酶增高,胆汁酸升高
尿的其他异常所见|R82|夜尿增多,尿血|尿不尽,蛋白尿||尿隐血,尿不尽,血尿蛋白尿,夜尿增多,尿动力检查后
颅内损伤|S06|呕吐,呼吸微弱,头疼,恶心,意识混乱,瞳孔异常,精神障碍,脉搏浅弱,血压低|大脑损伤,颅脑损伤||颅内损伤,脑损伤,脑损伤后,脑损伤后遗症,早产儿脑损伤,左侧脑损伤
头部其他和未特指的损伤|S09||头皮包块,头皮损伤,头皮疖疮,头皮血肿||头部其他和未特指的损伤,头皮血肿,头部外伤,头部外伤后,头部血肿,头皮疖疮
无主诉或诊断报告的人接受的其他特殊检查和调查|Z01||||孕前检查,检查,妇科检查,复查,查体
避孕问题|Z30||宫内节育,结扎,避孕||避孕问题,IUD,分粘,安曼月乐环后,安环,取环
生育问题|Z31||人工受精||生育问题,生育咨询,生育,咨询供精,人工授精,隐睾咨询
高危妊娠监督|Z35||胚胎停育,胚胎死亡,阴道不规则出血,雌孕激素下降||高危妊娠监督,胚胎停育,胎停,清宫
为其他咨询和医疗指导而与保健机构接触的人,不可归类在他处者|Z71||咨询||咨询,结果咨询,产前咨询,孕前咨询,孕妇咨询
