000|000||妇检||早孕,孕前,妇检,诊刮,周孕,妇科检查
000|000||牙髓坏死,牙髓炎,根尖周病,根尖周脓肿,根尖周囊肿,牙髓牙周综合征,龋齿,牙隐裂额,牙磨损|牙齿病变,牙髓病变,牙根尖病变|
000|000|||脾破裂,脾扭转,脾囊肿,脾肿瘤,霍奇金病,脾结核,脾脓肿,血液病,代谢病,脾功亢进|
病毒性和其他特指的肠道感染|A08|疲乏,稀便,黑便,血性大便|腹泻,发热,恶心,腹胀,呕吐,食欲减退,腹痛||肠道感染,轮状病毒肠炎,轮状病毒性肠炎,肠道病毒感染,病毒性肠炎,病毒性胃肠炎
其他传染性和未特指病因的胃肠炎和结肠炎|A09|腹部压痛,血性大便,胃肠气胀,肠出血,肠胃气滞,肠道湿热,脐腹痛,皮疹,肠鸣,稀便,中毒,排便障碍,大便溏泄,周身不适,粪便黑色,肌肉疼痛,胸膈间烧灼,肚子疼,头疼|发热,恶心,呕吐,食欲减退,里急后重,便血,腹胀,腹痛,便秘||胃肠炎,感染性腹泻,婴儿腹泻,胃肠型上感,痢疾
呼吸道结核,未经细菌学或组织学所证实|A16|消瘦,胸痛,乏力,纳差,消化不良|盗汗,咯血,咳嗽,咳痰,呼吸困难,低热||呼吸道结核,肺结核,粟粒性肺结核,淋巴结结核,右肺继发型结核,结核性胸膜炎
其他器官的结核|A18|脓疱,尿频,恶心,关节痛,呕吐,食欲减退,腰背痛,尿痛,压痛,疼痛|盗汗,疲乏,发热,消瘦,淋巴结肿大,腹痛,不孕,月经失调,下腹坠痛,查体腹部柔韧感,腹水,边界不清的囊性肿块,钙化结节||结核,盆腔结核,淋巴结结核,播散性结核病,结核感染,结核病
新生儿破伤风|A33|||哭闹,吃奶困难,牙关紧闭,面肌紧张,口角上牵,苦笑棉绒,阵发性双拳紧握,角弓反张,青紫,窒息,神志清楚的痉挛发作|
其他脓毒病|A41|反应差,嗜睡,发热,体温不升,少吃,少哭,少动,体重不增或增长缓慢|呕吐,腹胀,呼吸窘迫或暂停,青紫,肺炎,脑膜炎,坏死性小肠结肠炎,化脓性关节炎,骨髓炎|黄疸,肝脾肿大,皮肤黏膜瘀点,瘀斑,针眼处渗血不止,消化道出血,肺出血,休克,面色苍灰,皮肤呈大理石样花纹,血压下降,尿少或无尿,硬肿症,中毒性肠麻痹|
未特指部位的细菌性感染|A49|排尿障碍,发热,寒战,干咳,剧咳,胃痛,咽痛,恶心,呕吐,尿道烧灼感,尿道口有白膜,昏迷,尿频尿急,胀气,呼吸急促,食欲不振,腹痛,下腹疼痛,脓疱,上腹部疼痛,软组织感染,嗜睡,痉挛性咳嗽,尿道刺痒,排水样血性大便,尿痛,打嗝,黏痰,灼热感,头疼|免疫力降低,持续性弛张热||支原体感染,UU感染,链球菌感染,HP感染,支原体阳性
其他和未特指的梅毒|A53|低热,食欲减退,头痛,肌肉及关节骨骼酸痛|骨膜炎,关节炎,虹膜炎,视网膜炎,眼膜炎,主动脉炎,主动脉关闭不全,主动脉瘤,梅毒性脑炎,脑血管梅毒,麻痹性痴呆,视神经猥琐|不良性接触,外生殖器硬下疳,皮肤黏膜出现梅毒疹,皮肤黏膜树胶样肿或结节,溃疡|
其他主要为性传播的疾病,不可归类在他处者|A63|里急后重感,便血|淡红色丘疹,HPV,菜花样突起,人乳头瘤病毒||尖锐湿疣,外阴尖锐湿疣,湿疣,外阴假性尖锐湿疣,尖锐湿疣激光
未特指的病毒性脑炎|A86|寒战,畏光,咽痛,精神委靡,周身不适,颈项强直,眩晕,肌肉疼痛,腹痛|发热,嗜睡,头疼||未特指的病毒性脑炎,病毒性脑炎,病毒性脑炎后,病毒性脑膜脑炎,病毒性脑炎痊愈,病毒性脑干脑炎
疱疹病毒[单纯疱疹]感染|B00|疲乏,肛门湿疹瘙痒,斑疹,红斑样皮疹,恶心,呕吐,定向力障碍,昏迷,溃疡,腹股沟痒,黄白色水疱,头晕,嗜睡,周身不适,食欲减退,唇水疱,水疱,肌肉疼痛,牙龈痛,头疼,色素异常|口唇疱疹,生殖器疱疹,发热,淋巴结肿大,疱疹||疱疹病毒,单纯疱疹,感染,EB病毒感染,疱疹病毒感染,EBVHLH,疱疹,单纯疱疹病毒感染
水痘|B01|食欲下降,全身感染中毒,寒战,斑疹,血疱,水痘结痂,表皮全层坏死,胸痛,表皮下大疱,毒血症,咳血痰|疲乏,发热,咽痛,丘疹,咳嗽,结痂,淋巴结肿大,疱疹,头疼||水痘
其他以皮肤和粘膜损害为特征的病毒性感染,不可归类在他处者|B08|面部蝶形红斑,斑疹,咽喉部充血,无痛性肿块,身体不适,口唇疱疹,溃疡,脓疱,咽部溃疡,咽喉疼痛,唇水疱,瘙痒,结节,结膜充血,皮肤水疱,痘疮,厌食,头疼|发热,水疱,丘疹,咽喉肿痛,淋巴结肿大,疱疹||手足口病,疱疹性咽峡炎,幼儿急疹,手足口病痊愈
未特指的以皮肤和粘膜损害为特征的病毒性感染|B09|高热惊厥,咽痛,流涕|发热,水疱,丘疹,疱疹病毒,淋巴结肿大,触痛||病毒性皮疹,病毒性皮疹,过敏性皮疹
急性乙型肝炎|B16|发热,恶心,肝区疼,巩膜黄染,肝脾大,蜘蛛痣,食欲不振,腹胀,乏力,黄疸|乙肝,肝纤维化,面色晦暗发黄||急性乙型肝炎,乙肝,乙肝大三阳,乙型病毒性肝炎,乙肝携带,病毒性乙肝
巨细胞病毒病|B25|疲乏,抽搐,咳嗽,呼吸困难,智力低下,持续性黄疸,运动障碍,昏迷,,音,肝脾肿大,小头畸形,干咳|发热,肝脾肿胀,皮肤瘀点||巨细胞病毒病,巨细胞病毒感染,巨细胞病毒性肝炎,巨细胞病毒肝炎,巨细胞感染,CMV感染
传染性单核细胞增多症|B27|皮疹,肝大,咽痛,发热|脾大,淋巴结肿大,扁桃体肿大||传染性单核细胞增多症,传单,传染性单核细胞增多症,传染性单核细胞增多,传染性单核细胞增多症痊愈,传染性单核细胞增生症
未特指部位的病毒性感染|B34|脚长水泡,发热,红斑样皮疹,咽痛,咳嗽,肝区肿大,恶心,呕吐,唾液腺疼痛,脾肿大,吞咽困难,唾液腺肿大,眼睛发红,食欲较差,口长水泡,腹痛,疱疹,眼痛,食欲异常,关节痛,流鼻涕,畏寒,黏膜损害,腹泻,肌肉酸痛,肌肉疼痛,腮腺区肿大,手长水泡,面部疼痛,淋巴结肿大,头疼|病毒感染||病毒性感染,病毒感染,轮状病毒感染,乙肝病毒感染,病毒感染痊愈,病毒感染后指甲脱落
念珠菌病|B37|外阴红斑,丘疹,小水疱,外阴灼痛,外阴瘙痒,腹股沟红斑,阴道分泌物增多,鳞屑性皮疹,外阴红肿,外阴糜烂|豆腐渣样白带,白带增多,尿痛,外阴瘙痒,阴道粘膜红肿,小阴唇内侧及阴道粘膜附有白色块状物|外阴瘙痒,灼痛,部分有凝乳样,阴道分泌物增多|念珠菌病,VVC,RVVC,VVC治疗中,bv,尖锐湿疣
直肠乙状结肠连接处恶性肿瘤|C19||腹胀,呕吐,尿道排出混着液体,尿道口排气排便|无胎粪排出,直肠指检直肠闭锁或无肛门|
肝和肝内胆管恶性肿瘤|C22||黄疸,大便灰白,小便颜色深||
肝和肝内胆管恶性肿瘤|C22|体重降低,食欲不振,贫血|腹部膨隆,腹部包块||
胆道其他和未特指部位的恶性肿瘤|C24||右腹疼痛,厌油,食欲下降,皮肤瘙痒,肝区压痛,胆囊肿大,腹水|黄疸,大便颜色变浅,小便颜色变深|
鼻腔和中耳恶性肿瘤|C30|发热,四肢疼痛,呼吸困难,脱水,高血压|贫血,眶周淤斑,腹部膨隆,低钾性血症|横断性截瘫,Horner,综合征,单侧面部无汗,眼睑下垂,瞳孔缩小,眼球内陷,虹膜异色征|
支气管和肺恶性肿瘤|C34|声音嘶哑,胸痛,胸闷,气促|刺激性干咳,痰中带血,吸烟史,在化工行业工作||
骨和关节软骨其他和未特指部位的恶性肿瘤|C41|全身症状,贫血,恶病质|关节压迫,关节活动受限|关节疼痛,关节肿胀,关节肿块,隐痛逐渐加重|
卡波西肉瘤|C46|皮肤无痛性肿块,皮温高,发热,间歇性疼痛,体表痛性肿块|体表痛性肿块||卡波西肉瘤,EWS,RMS,横纹肌肉瘤,尤文肉瘤
其他结缔组织和软组织恶性肿瘤|C49|体重下降,发热|无痛性进行性增大的肿块||
乳房恶性肿瘤|C50|乳头皮肤糜烂,乳头回缩,乳头皮肤瘙痒,乳头灼痛|乳腺肿块,皮肤点状凹陷,乳头溢液|乳腺癌,酒窝征,橘皮样改变,桔皮样改变,乳房肿块边缘不规则,肿块活动度差,肿块活动受限|乳房恶性肿瘤,乳腺癌,乳癌,乳腺Ca,乳腺ca,乳腺CA
宫颈恶性肿瘤|C53|疼痛,尿痛,尿频,阴道分泌物增多,血尿,白带异常,尿急|血性阴道排液,不规则阴道出血|接触性出血,阴道排液,宫颈糜烂样改变,赘生物,宫颈肥大质硬,溃疡或空洞伴恶臭|宫颈恶性肿瘤,宫颈癌,宫颈Ca,宫颈CA,宫颈ca,宫颈癌Ib
子宫体恶性肿瘤|C54|盆腔绞痛,阴道分泌物增多,下腹胀痛,子宫出血,下腹部绞痛,尿痛,排尿困难,盆腔痛,阴道出血,下腹部疼痛|下腹包块,脓性分泌物,阴道不规则出血,阴道排液,下腹疼痛||子宫体恶性肿瘤,子宫内膜癌,宫内膜癌,子宫内膜Ca,内膜Ca,宫内膜Ca
卵巢恶性肿瘤|C56|不规则子宫出血,消瘦,持续性胀痛,绝经后出血|下腹包块,腹腔积液,下腹压痛,月经不调,下腹疼痛||卵巢恶性肿瘤,畸胎瘤,卵巢Ca,左卵巢畸胎瘤,右卵巢畸胎瘤,卵巢畸胎瘤
女性生殖器官其他和未特指的恶性肿瘤|C57|阴道流血,发热,衰弱,食欲不振|下腹肿块,阴道排液,浆液性黄水,下腹疼痛,多为钝痛,排液后疼痛缓解||卵巢恶性肿瘤,输卵管恶性肿瘤,右输卵管恶性肿瘤
睾丸恶性肿瘤|C62|转移症状,胸痛,咳嗽,咯血,呕吐,颈部肿块,骨痛,下肢水肿|睾丸钝痛,睾丸疼痛性肿块,腹部肿块,腹股沟肿块,腹股沟淋巴结肿大|睾丸肿胀,睾丸触痛,睾丸变硬,睾丸增大,睾丸肿块,睾丸坠胀|
肾(除外肾盂)恶性肿瘤|C64|头痛,腹部膨隆,咳血,腹部不对称,消瘦,精神萎靡|腹部肿块,血尿,腰痛||肾恶性肿瘤,WT,肾母细胞瘤,右肾母细胞瘤,肾母细胞瘤化疗
膀胱恶性肿瘤|C67|下肢水肿,发热,贫血貌,体重减轻,衰弱|尿内腐肉样组织排出,排尿困难,尿潴留,下腹耻骨上区扪及包块,腰骶部疼痛,肾积水,肾功能不全|血尿,间歇性血尿,间歇性肉眼血尿,尿频,尿急,尿痛|
眼和附器恶性肿瘤|C69|骶髂关节疼痛,关节红肿,尿道炎,消化道异常,呼吸系统异常,银屑病,皮肤病,强直性脊柱炎,Reiter综合征,炎症性肠道疾病,结核,梅毒|瞳孔缩小,眼红,眼痛,飞蚊症,羊脂状KP,尘状KP,玻璃体雪球状混浊,继发白内障,继发青光眼|眼痛,畏光,流泪,视物模糊,前房大量纤维蛋白渗出或反应性黄斑水肿,视盘水肿,视力下降,睫状充血,混合性充血,角膜后沉着物,前房闪辉,房水炎性细胞,前房积脓,虹膜粘连,虹膜膨隆,房角粘连,虹膜脱色素,Koppe结节,Busacca结节,虹膜肉芽肿,梅花状瞳孔,瞳孔闭锁,雪堤样改变|
眼和附器恶性肿瘤|C69|结膜充血,结膜水肿,角膜水肿,虹膜新生血管,玻璃体混浊,眼压升高,斜视|眼球膨大,牛眼,瞳孔散大,白瞳症,黄光反射||
甲状腺恶性肿瘤|C73||甲状腺肿块,肿块质地硬而固定,表面不平||
其他内分泌腺和有关结构的恶性肿瘤|C75|头痛,呕吐,多饮多尿|性早熟,视力障碍||
霍奇金[何杰金]淋巴瘤|C81|发热,盗汗,体重减轻|贫血貌|霍奇金淋巴瘤,非霍奇金淋巴瘤,淋巴结肿大,肝肿大,脾肿大|
未特指细胞类型的白血病|C95|盗汗,皮肤斑丘疹,持续性弛张热,呼吸异常,共济失调,咳嗽,胸闷,皮肤瘀点,视网膜出血,血小板减少,表情淡漠,心悸,丘疹,周身不适,结节,纵隔病变,气道陷闭,神疲乏力,体重减轻,继发感染,反复感染,视力异常,四肢无力,非感染性发热,上腔静脉回流受阻,骨髓抑制,反复高热,盆腔包块,溃疡,内脏出血,白细胞增多,关节痛,颈强直,头晕,血运障碍,全血细胞减少,感染性发热,纳差,纵隔增宽腹胀,头疼,体重下降,发热疲乏|面色苍白,淋巴结肿大,骨痛,胸骨压痛,肝区肿大,脾肿大,牙龈出血,血象异常,淋巴结肿大||白血病,ALL,ALLL,AMLM,APL,急性白血病
宫颈原位癌|D06|小腹疼痛,腰痛|尿频尿急尿痛,阴道出血,阴道分泌物增多|接触性出血,阴道排液,宫颈光滑或糜烂样|宫颈原位癌,CIN,CINI,CINIII,宫颈CIN,CINII
血管瘤和淋巴管瘤,任何部位|D18|呼吸道阻塞,脊椎僵直,肝区肿大,吞咽困难,食欲不振,偏瘫,颅内压增高,抽搐,脑室出血,截瘫,丘疹,巨唇,颈强直,脑叶出血,瘙痒,血管杂音,结节,腹部肿块,软组织肥大,头疼|血管痣,红斑样皮疹,血管畸形||血管瘤,血管瘤,皮肤血管瘤,背部血管瘤,淋巴管瘤,颅咽管瘤
黑素细胞痣|D22|皮肤黑点|痣,黑点,褐色点|扁平或略隆起的斑疹或丘疹,乳头状瘤,疣状,结节,黑痣|
乳房良性肿瘤|D24||乳房无痛性肿块,肿块边界清晰,肿块活动度好,乳头溢液|乳腺增生,乳腺囊肿,乳腺肿块|
子宫平滑肌瘤|D25|无宫缩间歇,脓血性白带,阴道分泌物增多,腹部肿块,子宫出血,阴道出血,外阴脱出肿物,巨大粘膜下肌瘤|腰背酸痛,白带增多,尿频,下腹坠痛,下腹包块,尿急,子宫增大,表面不规则结节突起||子宫平滑肌瘤,子宫肌瘤,多发性子宫肌瘤,子宫肌瘤挖除,子宫肌瘤剥除,子宫肌瘤切除
卵巢良性肿瘤|D27|耳聋,眼颤,颅内神经损伤,呼吸困难,意识障碍|双侧视乳头水肿,双眼上视不能,共济失调,性早熟,颅神经麻痹,尿崩症,嗜睡,视力视野障碍,颈部僵硬,复视,呕吐,呕血,黑便,睾丸结节状包块,睾丸不规则包块|颅内畸胎瘤,头痛,恶心,呕吐,胃畸胎瘤,腹部包块,腹胀,睾丸畸胎瘤,睾丸无痛性包块,睾丸硬包块|
其他和未特指部位的良性肿瘤|D36|肿瘤转移,全身症状,胸腔积液,血胸,体重下降,气促,贫血貌|持续性疼痛者,肋间神经痛,肋间神经痛反射到上腹部,骨质破坏,病理性骨折,胸壁肿瘤可发生中心坏死,溃破,感染或出血,咳嗽,呼吸困难,胸腔积液,胸内压迫症状|胸部疼痛,胸壁撞击痛,胸壁压痛,胸壁局部疼痛,胸壁压痛,胸壁包块|
口腔和消化器官动态未定或动态未知的肿瘤|D37|咽部不适异物感,咽痛,耳内痛,张口困难,听力减退,舌偏斜,发声障碍,唾液带血,口臭,呼吸不畅,呼吸困难吞咽困难,发热,肝脾大,消瘦,贫血|舌痛,舌运动受限固定,涎液增多外溢不能自控,进食吞咽言语困难,牙松动脱落,触之出血|溃疡,疼痛,肿块,鼻塞,鼻出血,鼻分泌物增多,流泪,眼球突出,皮肤溃疡,颊部感觉麻木迟钝,颈部淋巴结增大,间歇性麻木疼痛,进而持续性剧烈疼痛伴反射性疼痛,牙松动移位,面部畸形,病理性骨折|
中耳、呼吸和胸腔内器官动态未定或动态未知的肿瘤|D38|气促,干咳,吞咽困难,声音嘶哑,静脉怒张|||
女性生殖器官动态未定或动态未知的肿瘤|D39|子宫增大,尿频,瘤体牵拉,恶心,气急,咳血,心悸,血清甲胎蛋白升高,食欲不振,孕妇小腹痛腰痛下肢痛,子宫附件肿块,子宫出血,结节,尿痛,腹部肿块,疼痛,下肢水肿|下腹痛,腹胀,下腹部包块,阴道米汤样排液,不规则阴道流血,接触性出血,假孕症状,子宫不均匀性增大,卵巢黄素化囊肿||卵巢肿瘤,子宫肿瘤,侵袭性葡萄胎,子宫内膜间质肿瘤,卵巢混合性生殖细胞肿瘤
泌尿器官动态未定或动态未知的肿瘤|D41|全身症状,发热,贫血貌,体重减轻|尿频,尿急,尿痛,脓尿,尿路感染,尿道狭窄,血尿,无尿,少尿,尿滴沥|肾肿瘤,膀胱肿瘤,睾丸肿瘤,前列腺癌,阴茎癌|
脑和中枢神经系统动态未定或动态未知的肿瘤|D43|头痛,呕吐,头晕,癫痫,意识障碍|视力障碍,头围增大||
其他和未特指部位的动态未定或动态未知的肿瘤|D48|体表质软,体表无压痛,体表破溃,体表出血|体表呈针头大小黄豆大小的半圆球形|体表上的肿物|
其他和未特指部位的动态未定或动态未知的肿瘤|D48|畸形,病理性骨折,失眠,烦躁,贫血,恶病质等全身症状|附近关节活动受限,关节炎症状|骨疼痛,肿胀,骨性肿块,畸形|
其他和未特指部位的动态未定或动态未知的肿瘤|D48|畸形,病理性脊柱骨折,失眠,烦躁,贫血,恶病质等全身症状|脊椎活动受限,脊髓压迫引起神经功能障碍|脊柱疼痛,脊柱肿块|
其他和未特指部位的动态未定或动态未知的肿瘤|D48|上睑缺失,耳部畸形,脊柱异常,Goldenhar综合征|眼球突出,眶区疼痛,眶骨壁增生,慢性眼球突出,眼睑水肿,视力下降,肿块累计全眼眶|慢性眼球突出,眼睑水肿,视力下降,视盘水肿或萎缩,视神经睫状静脉,Foster-Kennedy综合征,眶骨壁增生,颧骨隆起,肿块生长快,眼球固定,肿块破溃,视力丧失,肿块累计全眼眶,眼睑鲜红,蓝色紫色的毛细血管及内皮增生,草莓痣,火焰痣,眼球小结节,眼球隆起较高,淋巴结增大,睑板弥漫性斑块状增厚,睑板菜花样,角膜缘实性肿物,角膜弧形脂质沉着带,角膜结膜交界处肿物,角膜白色半透明或胶冻样,角膜表面松针样新生血管,角膜缘菜花状肿物,角膜浆液脓性分泌物,先天血管发育异常,眼角淡红色圆形或似球形隆起,眼角扁平,边界不清楚的番茄色增厚,眼球突出,眶区疼痛|
其他和未特指部位的动态未定或动态未知的肿瘤|D48||慢性眼球突出,眼睑水肿,视力下降|慢性眼球突出,眼睑水肿,视力下降,视盘水肿或萎缩,视神经睫状静脉,Foster-Kennedy综合征,眶骨壁增生,颧骨隆起,肿块生长快,眼球固定,肿块破溃,视力丧失,肿块累计全眼眶|
其他贫血|D64|寒战,呼吸异常,咽部异物感,肝区肿大,气急,神经疼痛,咳血,牙龈苍白,腹胀呃逆,红细胞增多,肤色赤红,脾大,眼白发青,腹痛,气短急性贫血,上肢水肿,毛发稀少,心源性呼吸窘迫,大便溏泄,红细胞偏低,肝淤血,结节,心率加快,牙龈出血,腹部肿块,厌食,血压低,指甲凹陷,红细胞增多发热,红细胞体积增大,脓疱,少尿,水肿,头晕,便血,目光呆滞,胸痛,纳差,紫绀,身体虚弱,急性贫血,非感染性发热,舌炎,气促消瘦,乳糜尿,出血,面色苍白,胃酸缺乏,四肢畸形,面色觥白,小便难,眼前发黑,记忆力障碍,食欲减退,过敏,尿色深,肌肉疼痛,气短,头昏,心动过速,四肢无力,无力,胸骨压痛,呕血,背痛,吞咽困难,食欲不振,指甲翘起,淋巴液流出,眼花,皮肤黏膜苍白,新生儿贫血,皮肤干燥,溶血现象,生长缓慢,失血过多,脉搏加速,面部浮肿,畏寒,舌痛,腹部不适|疲乏,发热,黄疸骨髓象改变,恶心,呕吐,头晕食欲下降,脾肿大,眩晕,心悸,贫血,疲乏寒战,气血虚弱,关节痛,巩膜黄染,全血细胞减少,肝脾肿大,皮肤苍白,手足厥冷,褐色尿蛋白尿,心悸面部畸型,黄疸||贫血,缺铁性贫血,地中海贫血,地贫,AA
遗传性因子Ⅶ缺乏|D66|·|便血,刷牙出血,关节痛,鼻出血,牙龈出血,皮肤出血点||遗传性因子Ⅶ缺乏,血友病甲,血友病乙,血友病,重型血友病甲,血友病B
其他凝血缺陷|D68|伤口经久不愈,异性蛋白反应|皮肤紫癜,牙龈出血||其他凝血缺陷,凝血功能异常,凝血功能障碍,抗心磷脂抗体阳性,希特林蛋白缺乏症,抗心磷脂抗体
紫癜和其他出血性情况|D69|血压高,头疼,斑疹,腹部不适,咽痛,斑块,恶心,下肢红斑结节,呕吐,眼眶瘀斑,出血,皮肤血点,蛋白尿,尿血,内脏出血,溃疡,脓疱,皮肤青紫色,水肿,关节肿胀,畏寒,腹泻,便血,肾脏受累,胸痛,紫绀,鼻衄,皮肤瘙痒,紫癜,发绀,色素异常|发热,关节痛,皮肤紫癜,皮肤瘀点,瘙痒,血小板减少,牙龈出血,皮肤黏膜出血,腹痛||紫癜,过敏性紫癜,HSP,HSPN,ITP,紫癜性肾炎
紫癜和其他出血性情况|D69|关节痛,肌肉疼痛,血尿,蛋白尿|紫癜,红斑,丘疹,皮疹||
粒细胞缺乏|D70|白细胞减少,失眠多梦,头昏疲乏,两下肢沉重|粒细胞减少,经常感染||粒细胞缺乏,粒细胞缺乏症,粒细胞减少,粒细胞减少症,粒细胞缺乏,粒细胞降低
其他白细胞疾患|D72|急性失血,溶血,组织坏死,代谢紊乱,白细胞增高,嗜酸细胞增多,恶性肿瘤,血液病|关节痛,发热,乏力,反复感染||白细胞增高,嗜酸细胞增多症,白细胞减少,嗜酸细胞增高,白细胞降低
脾疾病|D73|贫血,消瘦,腹痛|肠道出血,肠梗阻,腹部肿块,大便次数及性状改变,粘液血便|小肠肿瘤,十二指肠肿瘤,空肠肿瘤,回肠肿瘤,阑尾肿瘤,结肠肿瘤,升结肠肿瘤,横结肠肿瘤,降结肠肿瘤,乙状结肠肿瘤,盲肠肿瘤,直肠肿瘤,直肠乙状结肠交界处肿瘤|
血液和造血器官的其他疾病|D75|疲乏,发热,血压高,骨髓发育异常,脓毒性血栓,肤色赤红,淋巴结肿大,红细胞增多,头疼,焦虑|血象异常,高原多血面容,紫绀||血液疾病,造血器官疾病,血小板增高,血小板增多症,血小板增多,原发性血小板增多症,血小板升高
与淋巴网状组织和网状组织细胞系统的某些疾病|D76|骨增粗,牙槽突型,皮肤紫癜,脊髓压迫,长骨肿胀疼痛,结节,肉芽肿,结痂,突眼症|皮疹,淋巴结肿大,肝脾肿大||LCH,HLH,噬血细胞综合征,嗜血细胞综合征,嗜血细胞综合症
000|D96|上腹痛|低蛋白血症,水肿,血管神经性水肿,皮疹,脐周或下腹疼痛,黑便,关节疼痛,肌肉疼痛,抽搐,高血压|紫癜,血尿,蛋白尿|
先天性碘缺乏综合征|E00|||单纯性甲状腺肿,甲状腺功能亢进,甲状腺功能减退,甲状腺结节,甲状腺瘤,急性化脓性甲状腺炎,亚急性甲状腺炎,桥本甲状腺炎,慢性纤维性甲状腺炎|
碘缺乏相关性甲状腺疾患和有关情况|E01|呼吸困难,声音嘶哑,吞咽困难,咳嗽|甲状腺肿大||碘缺乏,甲低,甲亢,甲减,暂时性甲低,甲状腺功能低下
其他非毒性甲状腺肿|E04|压迫感,结节样变,咳嗽,呼吸困难,吞咽困难,喘鸣,声带麻痹,声音嘶哑|甲状腺肿大,颈部肿块||甲状腺肿大,甲状腺结节,GD,甲状腺囊肿,甲状腺肿
甲状腺毒症[甲状腺功能亢进症]|E05|疲乏,呼吸异常,心跳加快,恶心,颤抖,出汗异常,呕吐,意识混乱,腹泻,血管杂音,昏迷,突眼症,气短,躁动|发热,消瘦,甲状腺肿大,多汗,结节,心悸,易激动|突眼,甲状腺机能亢进|甲状腺毒症,甲状腺功能亢进症,甲功异常,TS,高TSH血症,低TSH血症,低FT
甲状腺炎|E06|疲乏,寒战,咽痛,呼吸困难,月经不调,吞咽困难,腹胀,突眼症,脓疱,皮肤干燥,消瘦,心慌,结节,麻痹,体重减轻,气短,头疼,疼痛|发热,甲状腺肿大,畏寒,心悸,皮肤瘙痒,甲状腺机能亢进,声音嘶哑,甲亢面容,性欲减退||甲状腺炎,CLT,桥甲炎,乔甲炎,甲状腺炎,桥本氏甲状腺炎
甲状腺的其他疾患|E07|骨龄延迟,甲状腺肿大,声音嘶哑,吞咽困难,瘤块压迫|眼睑面颊虚肿,甲状腺功能低下,表情淡漠,智力减低||甲状腺疾病,低T
未特指的糖尿病|E14|肌肉萎缩,皮肤干燥,视力异常,视网膜脱离,视网膜水肿,视网膜出血,足底溃疡,间歇性跛行|多尿,多食,体重减轻,多饮||糖尿病,I型糖尿病,II型糖尿病,型糖尿病
胰腺内分泌的其他疾患|E16|听力减退,多囊卵巢,四肢俱软,嗜睡,心悸,缺血性挛缩,心率不齐,焦虑,血压高|向心性肥胖,糖尿||高INS血症,高胰岛素血症,胰岛素抵抗,低血糖
甲状旁腺功能减退症|E20||糖尿病,肥胖症,痛风,骨质疏松症|苯丙酮尿症,甲状腺功能低下,甲减,葡萄糖-6-磷酸脱氢酶缺陷,高促甲状腺激素血症,先天性肾上腺皮质增生,半乳糖血症,垂体功能减退症,肾上腺皮质疾病,嗜铬细胞瘤|
垂体功能亢进|E22|疲乏,生长激素分泌过多,恶心,舌体肥大,甲状腺肿大,性激素不足,呕吐,溢乳,背痛,昏迷,食欲不振,中心静脉压偏高,异常矮小,皮肤粗糙,多饮,食欲异常,多尿,嗜睡,昏睡,鼻端肥大,厌食,头疼|性早熟,身材发育异常||垂体功能亢进,CPP,中枢性性早熟,CP,CPP追高,高PRL血症
垂体功能减退和其他疾患|E23|疲乏,发热,视力改变,眼睑下垂,视力异常,恶心,甲状腺功能低下,呕吐,昏迷,毛发脱落,肥胖,视野缺损,皮肤干燥,尿崩,多尿,嗜睡,容貌娇小,出血性丘疹,烦渴多饮,生长激素分泌过少,头疼,血压高|身材矮小,生长缓慢||垂体功能减退和其他疾患,PGHD,GHD,部分生长激素缺乏症,生长激素缺乏症,下丘脑闭经
肾上腺性征疾患|E25|拒食,呕吐,嗜睡,腹泻,体重不增或下降,脱水,低血钠,高血钾,循环衰竭|体格发育过快,骨龄超出年龄,身材矮小,皮肤粘膜色素沉着,褶皱处明显|女孩男性化|
卵巢功能障碍|E28|潮红潮热,下身肥胖|多梦,四肢红斑,紧张,心悸,手脚冷,眩晕头疼失眠|多毛痤疮,黑棘皮症|卵巢功能障碍,PCOS,POF,卵巢功能低下,卵巢储备功能低下,卵巢早衰
青春期疾患,不可归类在他处者|E30|色素异常,皮质素不足,生长缓慢,皮下脂肪消失,异常矮小,阴道分泌物增多,腋毛生长加速,骨龄延迟,成人体味,外生殖器成熟,阴茎异常,阴道出血,骨骺提前闭合|阴毛早发育,青春期身体发育缓慢,胸部发育缓慢||青春期疾患,,乳房早发育,青春期追高,性早熟,青春期,小青春
其他内分泌疾患|E34|疲乏,发热,呼吸异常,腹部绞痛,体型异常,颈部潮红,囟门闭合晚,面部潮红,皮肤潮红,皮肤老化,心悸,全身毛发灰白,肿胀,腹胀,气喘型喘息,腹痛,异常矮小,肌肉萎缩,头晕,鸟嘴样尖鼻,腹泻,气短|身材矮小||内分泌疾患,矮身材,身材矮小,ISS,偏矮,矮小
夸希奥科病[恶性营养不良病]|E40|体温偏低,脉细无力,腹泻,便秘,重要脏器损害|活动减少,精神萎靡,反应差,食欲差|体重不增,体重下降,消瘦或水肿,皮下脂肪消耗,身高低于正常|
维生素A缺乏病|E50|口干,关节痛,皮肤干燥|泪河宽度下降,泪液分泌少,泪膜稳定性下降,泪液渗透压增加|泪液质量异常,泪液动力学异常,泪膜稳定性下降,眼部不适,眼部干涩感,眼部异物感,眼部烧灼感,眼部畏光,视物模糊,视觉疲劳,眼组织损坏|
营养不良和其他营养缺乏的后遗症|E64|皮肤干燥,骨痛,呼吸困难,皮肤松弛体重下降,骨骼突出,食欲减退,周身水肿,膝内翻膝外翻,皮下脂肪减少,新生儿抽搐,肌肉瘦弱,甲状旁腺机能减退,咽喉痉挛|X形腿,皮肤干燥体重下降,易激惹消瘦,步态不稳,鸡胸,营养不良,出牙延迟,婴儿出牙延迟,生长发育迟缓,肌张力减低,肋缘外翻,漏斗胸,O形腿,小儿哭闹不安||VD不足,佝偻病,VD低水平,早佝,VD正常低水平
肥胖症|E66|体型异常,活动后气促,打呼噜|脂肪代谢障碍|Bmi大于30,肥胖|肥胖症,肥胖,超重,单纯性肥胖,肥胖症,单纯肥胖
芳香氨基酸代谢紊乱|E70|嗜睡,食欲欠佳,呕吐,腹泻,惊厥,反应差,不爱活动|智力低下,精神神经症状,湿疹,皮肤抓痕征,个子长得很慢|尿有发霉的异味,鼠气味,色素脱失|
卟啉和胆红素代谢紊乱|E80|疲乏,疼痛,色素异常,腹部不适,心跳加快,乳糜尿,呕吐,虚弱,毛发异常,刺痛,皮肤红斑,皮疹,意识不清,腹痛,溃疡,便秘,皮肤损害,麻木感,瘙痒,疤痕,肌肉疼痛,起泡,痉挛,皮肤硬化|皮肤瘙痒,皮肤黄染,脾肿大||卟啉代谢紊乱,胆红素代谢紊乱,高胆红素血症,重度高胆红素血症,危险性高胆红素血症,高胆红素血症后,家族性高胆红素血症
矿物质代谢紊乱|E83|疲乏,四肢抽搐,嘴唇刺痛,抽筋,肝区肿大,呼吸困难,易怒,手指刺痛,腹痛,舌头刺痛,色素沉着,肌肉痉挛,糖尿,四肢麻木,双脚刺痛,肝功能异常,晨僵,恶心,呕吐,易激惹,烦躁不安,抑郁,肌无力,食欲不振,幻觉,消瘦,多尿,昏睡,血糖升高,记忆丧失,头疼|代谢异常||矿物质代谢紊乱,低钙,肺含铁血黄素沉着症,肺含铁,肝豆状核变性,肺含铁血黄素沉积症
躁狂发作|F30||鲁莽行为,言语迫促,注意力不集中,狂躁,思维奔逸,睡眠减少,语速增快||躁狂发作,抽动样,腹痛发作性
恐怖性焦虑障碍|F40|||对周遭环境感到恐惧,社交恐惧,对某样物品恐惧|
其他焦虑障碍|F41||紧张,害怕|过分担心,紧张害怕,没有明确的对象和内容|
强迫性障碍|F42|紧张,心慌|焦虑症病史|反复行为,反复检查,反复洗手,反复计数以及仪式性动作|
未特指的精神发育迟缓|F79|体型异常,智力减低,面部畸型,轻度精神发育迟滞,语言发育迟缓|精神发育迟滞,学习困难,智力发育迟缓||精神发育迟缓,智力低下,MR,交叉擦腿综合征,智力发育落后,智力落后
特定性言语和语言发育障碍|F80|抽搐,焦虑|语言发育迟缓,注意力不集中||特定性言语和语言发育障碍,语言发育落后,语言表达延迟,语言落后,语言发育迟缓,构音障碍
特定性学习技能发育障碍|F81|四肢麻木,肌肉痉挛,神经疼痛,肌肉萎缩,严重情绪障碍|认知功能障碍,学习困难,注意力不集中||学习障碍,学习困难
弥漫性[综合性]发育障碍|F84|兴趣狭窄,刻板重复|社会交往障碍,自闭,表情漠然,喜欢独处,交流障碍,孤独症,语言发育障碍||弥漫性发育障碍,孤独症,自闭症,孤独症谱系障碍,孤独症广泛发育障碍,孤独症倾向
多动性障碍|F90|品行障碍|注意力不集中,学习困难,活动过度,行为冲动||多动性障碍,ADHD,多动症,多动,好动,多动倾向
抽动障碍|F95|肌阵挛,强迫行为,点头征,躯体或颜面局部的连续性抽动,易激惹,摇头转颈,咽喉痉挛|不自主运动,面部肌肉痉挛,局部肢体抽动||抽动障碍,抽动症,抽搐,抽动,抽动障碍,嘴角抽动
通常在童年和青少年期发病的其他行为和情绪障碍|F98|尿细流,膀胱不稳定,尿频尿急,厌奶,膀胱充盈|偏食,挑食,尿失禁,尿床,遗尿,口吃||情绪障碍,遗尿症,遗尿,厌奶,挑食,偏食,口吃
细菌性脑膜炎,不可归类在他处者|G00|听力减退,呼吸异常,昏迷,瞳孔异常|发热,寒战,抽搐,脑膜刺激征,嗜睡,烦躁不安,头疼||细菌性脑膜炎,不可归类在他处者,细菌性脑膜炎,化脓性脑膜炎,化脓性脑膜炎后,隐球菌脑膜炎,化脓性脑膜炎痊愈
其他和未特指原因引起的脑膜炎|G03|发烧,呕吐,拒绝饮食,嗜睡,啼哭增加|严重头痛,讨厌强光和巨大的声音|颈部肌肉僵硬|
脑炎、脊髓炎和脑脊髓炎|G04|头痛,惊厥,出血疹,昏迷,高热|发热,恶心,颈强直,呕吐,意识模糊,头晕,嗜睡,烦躁不安,头疼||脑炎,脊髓炎和脑脊髓炎,脑炎,急性播散性脑脊髓炎,自体免疫性脑炎,脊髓炎,脑干脑炎
帕金森病|G20||肌张力障碍,运动障碍,不自主运动||
张力失常|G24|眼睑痉挛,强迫性人格,牙关紧闭,恶心,颤抖,呕吐,全身肌张力障碍,吞咽困难,频繁性惊醒|不自主运动,头颈部活动受限,运动功能障碍,舞蹈病样动作,节律性刻板重复的不自主运动,肌肉痉挛||张力失常,肌张力增高,运动障碍,肌张力降低,下肢肌张力增高,四肢肌张力增高
中枢神经系统的其他脱髓鞘疾病|G37|||剧烈神经根疼痛,四肢迟缓性瘫,四肢麻木刺痛感,烧灼感,多汗,面瘫|
癫癎[癫痫]|G40|恐惧,思维紊乱,语言发育迟缓,眼球偏斜,智力减低,记忆力消失,烦躁不安,复视,眩晕,幻听,咀嚼肌痉挛,心悸,婴儿睡觉出汗,腹痛,咽喉痉挛|肌阵挛,意识丧失,全身强直,智力发育迟缓,意识朦胧|癫痫样发作|癫,,癫痫,发作性症状,EP,痫性发作,婴儿痉挛症
偏头痛|G43|高血压,脑出血,畏光,出汗,畏声|呕吐,头部隐隐作痛,眼眶疼痛,恶心|一侧头痛|偏头痛
其他头痛综合征|G44|面色苍白,出汗,发作性头痛|头痛,头晕,呕吐,恶心||头痛综合征,发作性头痛,血管性头痛,头痛头晕,头晕头痛,发作性头晕头痛
睡眠障碍|G47|疲乏,机体崩溃,入睡困难,易怒,抑郁,肌张力丧失,睡眠性麻痹,打鼾,晚上醒来好几次,情绪低落,幻听,眼皮下垂,昏睡,精神不振,呼吸暂停,焦虑,深部性头痛|噩梦,失眠,注意力不集中,嗜睡,发作性睡眠||睡眠障碍,睡眠不良,睡眠障碍,睡眠差,发作性头晕,睡眠启动相关障碍
神经疾患|G51|眼皮跳,面具脸,伸舌,面部肌肉痉挛,对侧肢体偏瘫,无法说话,一侧颜面肥大,面颊动作不灵或歪斜|眼睑痉挛,鼻唇沟变浅,口角歪斜,口角下垂,感觉障碍,口眼歪斜||神经疾患,右侧面瘫,左侧面瘫,面瘫,周围性面瘫,神经皮肤综合征
重症肌无力和其他肌神经疾患|G70|疲乏,手臂无力,呼吸异常,恶心,呕吐,眼球运动障碍,腿部无力,咀嚼困难,麻痹,瞳孔异常,气短|视力模糊,眼外肌运动无力,构音障碍,口齿不清,吞咽困难,面肌无力,肌性肌无力|眼睑下垂|重症肌无力,肌神经疾患,MG,重症肌无力,MG眼肌型,MG眼肌性,肌无力
肌肉的原发性疾患|G71|走路年龄推迟,易跌,行走缓慢,跌倒后不易爬起|骨骼肌萎缩,无力||肌肉的原发性疾患,进行性肌营养不良,肌营养不良,先天性肌营养不良,杜兴氏肌营养不良,先天性肌病
大脑性瘫痪[脑瘫]|G80|截瘫,感觉障碍,吸吮反射消失,大小便失禁,躯干姿势异常,小儿流口水|不自主运动,吞咽障碍,舞蹈样手足徐动,肢体瘫痪,构音障碍,步态异常||大脑性瘫痪,脑瘫,脑发育不良,脑性瘫痪
偏瘫|G81|轻偏瘫,手有僵硬抵抗感,痉挛性偏瘫|口角歪,肌张力增高或降低,头眼偏斜||偏瘫,右侧偏瘫,左侧偏瘫,右侧轻偏瘫,小儿交替性偏瘫
脑积水|G91|颅内压增高,婴儿喂养困难,情感淡漠,惊跳,视力异常,耳廓红肿,易激惹,鼓膜发红,意志丧失性格,前囟饱满,前囟张力增高,昏迷,步态异常|抽搐,步态不稳,头颅增大,恶心,情绪不宁,呕吐,易醒,头疼|典型症状为头痛,呕吐,视力模糊,视神经乳头水肿,偶伴复视,眩晕及癫痫发作,婴幼儿头围增大,前囟扩大,张力增高,,落日目,现象,头颅透照性,视神经乳头萎缩|脑积水,双积水,右积水,积水,梗阻性脑积水
脑的其他疾患|G93|共济失调,发热,呼吸异常,步态不稳,血压偏低,脑膜刺激征,心悸,震颤,视乳头水肿,脑干损害体征,痉挛性截瘫步态,去大脑强直,溶酶体酶缺陷,记忆力障碍,眼干涩酸胀,血压波动大,头昏,瞳孔异常,心动过速,短头畸形,超雄,无力,易疲劳,烦躁不安,腭部可见小出血点,昏迷,精神萎靡,颈椎痛,腕部疼痛,耳流脓,癫痫样发作,颅脑损伤后头痛,头晕,嗜睡,昏睡,颈椎增生,颅内感染,感染性发热,下肢无力,呼吸暂停,面色潮红|肌张力降低,意识状态变化,呕吐,头疼,恶心||HIE,缺氧缺血性脑病,蛛网膜囊肿,缺血缺氧性脑病,脑软化,小脑扁桃体下疝
脊髓的其他疾病|G95|大小便障碍|下肢感觉障碍,运动功能障碍,下肢畸形|腰骶部特异性皮肤异常,皮肤小凹陷,皮肤窦道,局部多毛或皮毛窦,腰部中线部位血管瘤,不对称臀裂等|
脊髓的其他疾病|G95|感觉运动功能障碍,大小便障碍|腰骶部疼痛,会阴部感觉减退,慢性下腰部,骶尾部,会阴部疼痛不适,大腿背侧疼痛,坐骨神经痛,神经源性跛行||
中枢神经系统的其他疾患|G96||低头用力鼻腔液体增加,压迫颈静脉使鼻腔液体增加|鼻腔流出清亮或淡红色液体|
眼睑的其他炎症|H01|发热,寒战,头疼,全身不适,神经痛,耳前淋巴结肿大,皮肤瘢痕,败血症|眼睑硬结,眼睑压痛,眼睑肿胀,睫毛和睑缘鳞屑,点状皮脂溢出,黄色蜡样分泌物,眼痒,眼刺痛,眼睑烧灼感,秃睫,睫毛乱生|睑板腺囊肿,眼睑皮下圆形肿块,睑结膜紫红色或灰红色|麦粒肿,霰粒肿,睑板腺囊肿
眼睑的其他疾患|H02|眼睑麦粒肿,眼睑红肿|眼睑肿胀,眼睑下垂||眼睑下垂,双眼睑下垂,眼睑麦粒肿,眼睑红肿,眼睑肿胀,倒睫,上睑下垂,眼睑色素痣,乱睫,睑内翻,睑外翻,睑闭合不全,兔眼,内眦赘皮,先天性睑裂狭小综合征,先天性小睑裂
泪器系疾患|H04|疲乏,泪腺囊肿,发热,眼痛,皮肤干燥,味觉减退,泪腺发炎,眼干,结膜异物,口干舌燥,泪腺肿大|泪溢,结膜充血,鼻泪管阻塞||泪器系疾患,鼻泪管堵塞,鼻泪管阻塞,泪囊堵塞,鼻内管堵塞,泪囊炎,泪道阻塞
眼眶疾患|H05||鼻窦炎,高热,恶性,呕吐,头痛,昏迷,脑脓肿,海绵窦血栓,败血症|骨髓炎,骨膜炎,眼眶蜂窝织炎,眼球筋膜炎,血栓静脉炎,眼眶结核,眼球突出,角膜炎,视力下降,眼痛|
结膜炎|H10|眼睑痉挛,眼痛,视力异常,脓性分泌物,泪溢,眼睛痒,眼疲劳,眼睑浮肿,眼睑脓肿,睑结膜充血,结膜异物,流泪增多,眼睑肥厚,两眼干涩|流泪,畏光,眼屎多,眼内有异物感|结膜充血|结膜炎,过敏性结膜炎,左眼结膜炎,右眼结膜炎,急性结膜炎
结膜的其他疾患|H11||结膜色素瘤,乳头状瘤,脂肪瘤,结膜鳞状细胞癌,结膜上皮内瘤变,结膜恶性黑色素瘤,痣,疣,乳头状或凝胶状,肉样|结膜炎,异物感,烧灼感,痒,畏光,流泪,结膜充血,水肿,结膜渗出物,结膜乳头状增生,滤泡,伪膜,真膜,肉芽肿,假性上睑下垂,耳前淋巴结增大|
角膜炎|H16||角膜外伤史,戴角膜接触镜史,淋球菌感染的经阴道分娩|眼痛,畏光,流泪,眼睑痉挛,视力下降,睫状体充血,角膜浸润,溃疡形成,房水闪辉,房水浑浊,前房积脓,瞳孔缩小,虹膜后粘连,球结膜水肿,充血,脓性分泌物|
角膜的其他疾患|H18|上睑缺失,耳部畸形,脊柱异常,Goldenhar综合征|角膜散光,视力下降|角膜缘实性肿物,界清,弧形脂质沉着带,角膜结膜交界处肿物,白色半透明或胶冻样,表面松针样新生血管,界限清楚,角膜缘菜花状肿物,浆液脓性分泌物|
其他白内障|H26||先天性白内障,外伤性白内障,老年性白内障,代谢性白内障|晶状体浑浊,视力下降,对比敏感度下降,屈光改变,复视或多视,眩光,色觉改变,视野缺损|
其他视网膜疾患|H35|色觉异常,眼底出血,视力异常,黑蒙,眼前冒紫烟,腹部痉挛,阴道流出液体,眼底樱桃红斑,阴道流血,红眼,中央视觉的迅速消失,后背下部疼痛,腹痛,视网膜静脉曲张,盆腔坠痛,视野缺损,阴道出血,玻璃体有血迹,假性近视,眼痛,宫缩,视力视野障碍,答话不清,水肿,视物出现扭曲,疣状增殖,眼底改变,虹视|视网膜出血,夜盲,视物模糊,视网膜脱离,视网膜水肿,视物变形,视野障碍||视网膜疾患,眼底筛查,新生儿眼底筛查,眼底检查,早产儿筛查,早产儿视网膜病变
青光眼|H40|恶心,头痛,呕吐|青光眼,眼压升高,房角改变,视野缺损,视盘改变,剧烈头痛,畏光,流泪,视力严重减退,眼睑水肿,混合性充血,角膜上皮水肿,房水浑浊,前房浅,虹膜膨隆,房角狭窄,突感雾视,虹视,额部疼痛,鼻根部酸胀,瞳孔扩大,光反射迟钝,压延波动,不稳定,房角开放,眼底改变,视盘凹陷进行性扩大加深,视盘杯盘比增大,双眼凹陷不对称,视盘线装出血,视网膜神经纤维层缺损|青光眼斑,扇形虹膜萎缩,色素脱失,局限性后粘连,瞳孔散大固定,房角广泛粘连,青光眼性视盘凹陷,视野缺损,前房钱,房角窄,畏光,流泪,眼睑痉挛|
其他斜视|H50||弱视,屈光不正,复试,视觉疲劳,阅读困难,视物模糊,头痛,畏光,眼球运动受限|先天性内斜视,调节性内斜视,非调节性内斜视,非共同性内斜视,间歇性外斜视,恒定性外斜视,垂直斜视,AV型斜视,垂直分离性斜视,DVD,,先天性脑神经发育异常综合征,甲状腺相关眼病,上斜肌肌鞘综合征|
屈光和调节疾患|H52|黄斑出血,视网膜下新生血管,豹纹状眼底,近视弧形斑,色素沉着|近距阅读眼酸,头痛,视觉疲劳,夜间视力差,飞蚊症,漂浮物,闪光感,不能聚焦,双眼屈光度数不等|近视,远视,散光|
视觉障碍|H53|单眼斜视,屈光参差,高度屈光不正,形觉剥夺||双眼最佳矫正视力下降,眼部检查无器质性病变|
眼震和其他不规则眼运动|H55|||非自主,有节律的眼球摆动,冲动型眼球震颤,钟摆型眼球震颤,水平性眼球震颤,垂直性眼球震颤,旋转性眼球震颤,混合性眼球震颤,先天性眼球震颤,后天性眼球震颤|
眼和附器的其他疾患|H57|||眼睑病,泪器病,眼表疾病,结膜病,角膜病,巩膜病,,晶状体病,青光眼,葡萄膜病,玻璃体病,视网膜病,视路疾病,屈光不正,眼眶疾病,眼外伤|
化脓性和未特指的中耳炎|H66|听力减退,耳漏,耳内闭塞感,耳廓红肿,耳根部疼痛,耳鼓膜破裂,挖耳出血|耳痛,鼓膜充血,咽鼓管堵塞,耳内发胀|耳道流脓|化脓性和未特指的中耳炎,中耳炎,化脓性中耳炎,右耳中耳炎,左化脓性中耳炎,左耳急性化脓性中耳炎
其他听觉丧失|H91|听觉过敏,幻听,头痛|耳鸣,眩晕,耳闷|听力下降,对声音无响应|
风湿性三尖瓣疾病|I07|呼吸困难,水肿,皮肤冷,颈部搏动|食欲下降,疲乏,发热,单项Alt升高,大块肝细胞坏死,压痛,肝区痛,右上腹疼痛||风湿性三尖瓣疾病,三尖瓣反流,三尖瓣轻度反流,胎儿三尖瓣反流,三尖瓣少量反流,轻度三尖瓣反流
特发性(原发性)高血压|I10||头晕,头痛,心悸,胸闷,呕吐,眩晕|血压高,高血压|
其他肺源性心脏病|I27|疲劳,乏力,神经系统症状,食欲缺乏,恶心,呕吐,上腹胀痛,脱发,光敏,口腔溃疡,关节炎|运动耐量减低,晕厥,猝死,心绞痛,胸痛,咯血,声音嘶哑,双下肢,会阴,腰骶部水肿,胸腹水,口唇,指尖,耳廓发绀|呼吸困难,进行性活动后气短|
肺血管的其他疾病|I28|复视,胸痛,肺部造影异常|紫绀,晕厥,活动后呼吸困难,心脏杂音||肺血管的其他疾病,PS,肺动脉狭窄,PS介入,重度PS,PS扩张
急性和亚急性心内膜炎|I33|全身不适,乏力,食欲不振,体重减轻,咳嗽,呼吸困难,咯血,胸痛,肺坏死空洞,脓气胸,脾大,贫血|心脏杂音,发热,弛张性低热,39℃,头痛,背痛,肌肉关节痛,突发心力衰竭,瘀点,指和趾甲下线状出血,微血管炎,微栓塞,动脉栓塞,脑栓塞,肺栓塞|心脏出现粗糙响亮杂音,心脏有呈海鸥鸣样杂音,心脏有音乐样的杂音,Roth斑,Osler结节,Janeway损害|
非风湿性三尖瓣疾患|I36|生长发育差,瘦小,紫绀,颧颊潮红,奔马律,肝脏搏动|出生一周内呼吸困难,紫绀,充血性心力衰竭,预激综合征,胸痛,室上性心动过速|童年期逐渐出现劳累后气急,心悸,紫绀,心脏杂音,三尖瓣关闭不全,收缩期杂音,三尖瓣狭窄产生的舒张期杂音,吸气时杂音响度增强|
肺动脉瓣疾患|I37|劳动耐力差,气急,头晕,肝脏肿大,劳累后心悸,剧烈运动后昏厥发作,乏力,颈静脉怒张|疲乏,嘴唇发青,下肢水肿,心率过快,劳动后气急||肺动脉瓣疾患,肺动脉瓣狭窄,肺动脉瓣狭窄球囊扩张,肺动脉瓣狭窄介入,重度肺动脉瓣狭窄,肺动脉瓣重度狭窄介入
瓣膜未特指的心内膜炎|I38|呼吸困难,咳嗽,,心悸,咯血,紫绀,乏力,肺水肿,心前区痛,嘎声,吞咽困难|心力衰竭,心律失常,呼吸困难|二尖瓣狭窄,二尖瓣关闭不全,主动脉瓣狭窄,主动脉瓣关闭不全,多瓣膜病,心房心室结构改变,心房心室功能失常|
心肌病|I42|血压低,肝区肿大,胸闷,气急,端坐呼吸,下肢水肿,头晕,心脏杂音,昏迷,胸痛,活动后气促,心动过速|疲乏,发热,肌肉酸痛,咽痛,心悸,呼吸困难||心肌病,心内膜弹力纤维增生症,心弹纤,心肌致密化不全,心肌病,心肌损伤
其他传导疾患|I45||低血压,休克,心力衰竭,房颤,房扑,心室颤,猝死|心动过速|
阵发性心动过速|I47|胸闷,气短,呼吸困难,乏力,血压下降,脉细速,多尿,出汗|心绞痛,头晕,晕厥,心力衰竭,抽搐,休克|心动过速突然起始与终止,心率间长短不一,心悸,焦虑不安,心律规则,150,250次/分|
其他心律失常|I49|室颤阈值降低,咳嗽,紧张,虚弱,脑缺血,胸闷不适,血流迟缓,胸口紧迫感,意识丧失,面色青紫,眼前发黑,迷走神经张力增高,四肢麻木,心跳过速,暴饮暴食血压低,抽搐心率不齐,意识短暂中断,瞳孔异常,焦虑,气短,头昏,血压低,黑蒙,恶心,心搏漏跳,无力,呕吐,血压下降,烦躁不安,昏迷,抽搐血流动力学障碍,胸痛,头疼|疲乏,传导阻滞,胸闷,呼吸困难,头晕,心慌,心悸,心率不齐,气短,心动过缓,心动过速||心律失常,室性早搏,频发室早,房性早搏,阵发性室上性心动过速
心力衰竭|I50|意识障碍,濒死感,皮肤湿冷,肺部衄乏力,喘息不止|端坐呼吸,频繁咳嗽,下肢水肿,泡沫样痰,活动后呼吸困难||心力衰竭,肌酶增高,心肌酶增高,心肌损害,CK增高,心力衰竭
心脏病的并发症和不明确表述|I51|健忘,肺弃血,发热,呼吸异常,腿脚浮肿,血压低,咳嗽,胸闷,恶心,呕吐,血压下降,心脏肥大,肺淤血,食欲不振,腹胀,指甲床发绀,甲亢面容,腹痛,心率不齐,收缩期杂音,头晕,食欲减退,体重减轻,身体瘦弱,头疼|疲乏,心脏增大,呼吸困难,气急,胸闷,心悸,胸痛,肝脾肿大,颈静脉怒张,气短,心动过速,发绀||心脏病的并发症,心肌炎,心包心肌炎,心肌疾病,心脏扩大,心脏增大,心脏病
蛛网膜下出血|I60|剧烈头痛,恶心,呕吐,短暂意识障碍|突发头痛,脑膜刺激征,动眼神经麻痹,失语,单瘫,项背部疼痛,畏光||
其他非创伤性颅内出血|I62|头皮下血肿,前囟张力增高,瞳孔异常,遗尿,偏瘫|颅内压增高,恶心,呕吐,头晕,烦躁不安,头疼||颅内出血,颅内出血引流,早产儿颅内出血,新生颅内出血,颅内血肿,脑出血
其他脑血管病|I67|发病前有剧烈运动史,头痛,呕吐,昏迷,血压升高,体温升高|颈项强硬,克氏征阳性,头痛伴随脖子发硬,一侧眼睛睁不开,视物重影,患侧眼皮不能上抬,眼球突出||
其他脑血管病|I67|频繁的癫痫发作,部分性发作或癫痫持续状态,伴脑电图癫痫样放电|急性脑卒中,导致持续性瘫痪,失语,视觉障碍和智力障碍|脑缺血发作,一过性瘫痪,偏瘫,惊厥发作,头痛,偏头痛,感觉障碍,不自主运动或智力障碍|
动脉粥样硬化|I70|全身不适,易疲劳,发热,食欲不振,恶心,出汗,体重下降|四肢疼痛,臂动脉搏动减弱或消失,股动脉搏动减弱或消失,肺水肿,充血性心衰|肾区血管杂音,肾区疼痛,肾功能不全伴高血压,肾功能不全伴高血压|
主动脉瘤和主动脉夹层|I71|降主动脉瘤可侵袭椎体,压迫脊髓引起截瘫|腹主动脉瘤,下背部疼痛,上腔静脉综合征,呼吸困难,咳嗽,喘鸣,甚至继发感染,咯血,声音嘶哑,吞咽困难,呕血|胸主动脉瘤,上胸部疼痛,背部疼痛,肩胛下向左肩放射疼痛,肩胛下向颈部放射疼痛,肩胛下向上肢放射疼痛|
其他周围血管疾病|I73|静息痛,指甲异常,手皮肤发紫,皮肤潮红,肿胀,皮肤苍白,手臂部刺痛,溃疡,间歇性跛行|麻木感,发凉,肢体发凉,发绀||血管疾病,跛行,右下肢跛行,右脚跛行,右腿跛行,间歇性跛行
静脉炎和血栓性静脉炎|I80|静脉血管瘤,出血,感染,恶变,危及生命|静脉血栓,静脉回流障碍,肢体疼痛,肢体轻度肿胀,肢体活动受限,皮肤温度升高,深静脉走向压痛,肺栓塞|血管形态改变,静脉曲张,静脉血管迂曲成团,静脉血管隆起,静脉迂曲增大,血液回流,静脉瓣关闭不全,血管直径增大,皮肤瘙痒,皮肤疼痛,皮肤损伤,皮肤溃疡,出血|
下肢静脉曲张|I83|长期站立病史,湿疹,皮肤色素沉着,脂性硬皮病,血栓性静脉炎|皮肤瘙痒,患肢沉重感,张力升高,久站后踝部肿胀,皮肤肌肉疼痛,皮肤损伤,皮肤溃疡,皮肤出血|静脉迂曲增大,静脉血管迂曲成团,静脉血管隆起,血液回流,静脉瓣关闭不全,血管直径增大|
其他部位的静脉曲张|I86|乏力|阴囊疼痛,精索局部温度升高|患侧阴囊胀大,阴囊坠胀感,阴囊隐痛|
静脉的其他疾患|I87|体型瘦长,左腰腹痛|血尿,蛋白尿||胡桃夹综合征,左肾静脉压迫综合征,胡桃夹综合症,左肾静脉胡桃夹综合征,左肾静脉胡桃夹综合症
非特异性淋巴结炎|I88|淋巴结疼痛,脓疱|发热,淋巴结肿大,压痛,腹痛,咽痛||非特异性淋巴结炎,肠系膜淋巴结炎,颈部淋巴结炎,颈淋巴结炎,淋巴结炎,颌下淋巴结炎
淋巴管和淋巴结的其他非感染性疾患|I89||疼痛,浮肿,感觉异常,皮肤温度改变,皮肤色泽改变,胀痛,炎症|淋巴结肿大,淋巴回流受阻,淋巴水肿,象皮肿|
急性鼻咽炎[感冒]|J00|发热,疲惫,全身乏力,精神萎靡|咽痛,咳嗽,流涕,咽部充血,扁桃体肿大||
急性鼻窦炎|J01|发热,耳鸣|鼻塞,咳嗽,咳痰,头面部胀痛,呼吸不畅,呼吸受阻|流黄色涕,流黄绿色鼻涕,嗅觉减退|
急性咽炎|J02|||咽部不适,咽部疼痛,嗓子痒或干燥感,嗓子灼热感,咽部异物感,刺激性咳嗽,晨起咳嗽|咽炎
急性扁桃体炎|J03|发热|咽痛,嗓子疼,淋巴结肿大||
急性喉炎和气管炎|J04|发热|淋巴结肿大|声音嘶哑,嗓子疼痛,咽痛|
多发性和未特指部位的急性上呼吸道感染|J06|疲乏,扁桃体发炎,咳嗽,怕冷,吞咽困难,感冒,鼻痒鼻溢液,呼吸急促,食欲不振,舌苔黄,倦怠,咽喉灼热感恶寒发热,颈部肿大,口燥咽干,眼痛,吞咽疼痛,畏寒,鼻脓涕有臭味,喉咙痛,深部性头痛咽部溃疡,淋巴结肿大|发热,咽痛,打喷嚏,呼吸困难,流鼻涕,鼻塞,吞咽痛,咳嗽脓鼻涕,扁桃体肥大,发热声音嘶哑,失音,咳痰,肌肉疼痛,头疼||急性上呼吸道感染,上感,急性扁桃体炎,急性化脓性扁桃体炎,扁桃体炎
流行性感冒,病毒未标明|J11|发热,胸骨,咳嗽,呕吐,头痛,极度乏力,呼吸急促,全身肌肉酸痛,乏力,腹痛,咽喉痛,畏寒,食欲减退,腹泻,发绀,干咳|咽痛,脓性痰,肺部有湿衄,流涕,鼻塞|突发高热,全身疼痛,全身乏力,咳嗽|流行性感冒,感冒
肺炎,病原体未特指|J18|盗汗,疲乏,肝区肿大,胸闷,高热,气急,面色苍白,腹痛,出汗异常,血痰,意识混乱,周身不适,肌肉酸痛,体重减轻,厌食,心慌气短,咽部异物感,咽痛,恶心,鼻塞,呕吐,烦躁不安,昏迷,腹胀,脓疱,关节酸痛,消瘦,畏寒,肺部感染,胸痛,紫绀,头疼|发热,寒战,咳嗽,呼吸困难,衄咳痰,脓痰,气短||支气管肺炎,肺炎,喘息性肺炎,喘息性支气管肺炎,支原体肺炎
急性支气管炎|J20||声音嘶哑,声带麻痹,吞咽困难,肩痛,骨关节综合征,杵状指,骨关节痛,骨膜增厚,气急,喂奶呛咳史或咳嗽史,咳出食物颗粒,支气管扩张|阻塞性呼吸困难,吸气时喘鸣,喂食困难,发绀,吸气时锁骨上窝,肋间软组织和剑突下组织凹陷,刺激性咳嗽,痰中带血,咯血,胸闷,气促,哮喘,胸痛|
血管舒缩性和变应性鼻炎|J30|耳朵痒,时不时用力去挖耳孔,多动或者抽动,注意力很难集|下眼皮肿胀,频繁咽喉痒清嗓子,打呼噜,伴随张嘴呼吸|突然发作的打喷嚏,流涕,鼻塞|
慢性鼻炎、鼻咽炎和咽炎|J31|头疼,鼻屎多,鼻内发痒,咳嗽,恶心,流鼻涕,鼻粘膜肿胀,鼻腔干燥,鼻腔结痂,喉部堵塞感,局部灼热,深部性头痛鼻毛脱落,鼻孔干疼,风热犯肺鼻痒|咽喉部充血,鼻塞,打喷嚏,鼻粘膜干燥发痒,吞咽痛,鼻痒,鼻粘膜肿胀鼻溢液,咽部异物感,流清涕||慢性鼻炎,鼻咽炎和咽炎,鼻炎,过敏性鼻炎,AR,慢性咽炎
鼻息肉|J33|耳鸣,鼻部麻木感|阵发性鼻塞,流鼻涕|蛙状鼻,嗅觉下降,睡眠打鼾,闭塞性鼻音|
扁桃体和腺样体慢性疾病|J35|疲乏,扁桃体发炎,发热,咳嗽,胸闷,下颌疼,喉咙疼,耳鸣,吞咽困难,耳朵疼,打鼾,声音沙哑,口臭,呛咳,气短,头疼,深部性头痛|听力减退,咽痛,扁桃体肥大,腺样体面容,扁桃体发红,耳闷,咽鼓管堵塞,咽部异物感||反复扁桃体炎,慢性扁桃体炎,腺样体肥大,扁桃体肥大,腺样体增生
声带和喉疾病,不可归类在他处者|J38||紫绀,呼吸困难,三凹征,咳嗽|喘鸣,声嘶,失声,咽喉异物感|喉囊肿,喉狭窄,声带息肉,声带小结,喉炎,喉咽炎,咽喉炎
上呼吸道的其他疾病|J39||咳嗽有痰,咳出费力,胸廓呼吸动度,语颤减弱消失,叩之浊音,呼吸音低或消失,干或湿罗音|气急,呼吸困难,喘鸣|
支气管炎,未特指为急性或慢性|J40|疲乏,疼痛,咳嗽低热,发绀,咽喉痉挛,心跳加快,深色或黄色痰液,脓性分泌物,呼吸困难,咽喉部充血,背疼,皮肤紫绀,喉头水肿,烦躁不安,吞咽困难,呼吸急促,咽喉痛,口燥咽干,脓疱,进食困难,肌阵挛,压痛,胸痛干咳,肌肉疼痛,痰呈粘液脓性,气短,淋巴结肿大,咽部异物感,咯痰|喘鸣,发热,寒战,咳嗽,鼻塞,黏液痰,鼻翼煽动,咳声嘶哑,咽喉痛,呼吸急促,咳痰,卡他,流鼻涕,肌肉酸痛|发作性喘憋|支气管炎,喘息性支气管炎,喘支炎,喉气管,支气管炎,毛细支气管炎
肺气肿|J43|咳嗽,呼吸困难|胸闷,气短,咯血,胸痛,突发胸痛,喘憋||
哮喘|J45|胸闷气短,发热,心跳加快,呼吸音减弱,腹痛,喉鸣声,流鼻涕,神志不清,反酸,气息异常,过敏,鼻衄,气短,干咳,气促,恶心,鼻腔阻塞,呕吐,脸色乌青,发音改变,颜面潮红,呼吸异常,咳痰,睡觉后全身大汗淋漓,上腹部疼痛,消瘦,嗜睡,喘息,结膜充血,衄胸痛,皮肤瘙痒,发绀|痉挛性咳嗽,打喷嚏,胸闷,呼吸困难,哮鸣音,咳嗽||哮喘,CVA,支气管哮喘,咳嗽变异性哮喘,哮喘发作,哮鸣音
有机粉尘引起的过敏性肺炎|J67||过敏性鼻炎史,过敏性结膜炎史||
其他间质性肺疾病|J84|黏液浓痰,厌食,四肢关节痛|消瘦,双肺中下部有衄乏力,发绀,呼吸急促||间质性肺炎,间质性肺病,毛细支气管炎肺炎
肺和纵隔脓肿|J85|高热,咳嗽,畏寒,精神不振,全身乏力,食欲减退等||咳大量脓臭痰|
脓胸|J86|发热,周身不适,食欲不振|胸痛,呼吸急促,不能平卧,患侧胸部呼吸受限||
气胸|J93|0|突发胸痛,而胸闷,呼吸困难,刺激性干咳||
其他胸膜情况|J94|低热,乏力,咳痰|胸闷,呼吸困难,气促,气短,胸痛,胸膜摩擦感,胸廓活动受限||
其他呼吸性疾患|J98|耳痛,心动过速,咳血痰,呼吸异常,寒战,恶心,胸闷,吸气困难,呕吐,虚弱,血压下降,烦躁不安,吞咽困难,昏迷,腹胀,腹痛,消瘦,水肿,头晕,痰有恶臭味,气息异常,衄紫绀,气短,发绀,头疼|咳痰,呼吸困难,发热,胸痛||肺部感染,支气管,喘息性支气管,支气管软化,弥漫性肺疾病
牙发育和出牙疾患|K00|牙齿斑块|磨牙,牙釉质腐蚀,出牙延迟,牙齿白垩色到褐色的斑块||牙发育和出牙疾患,磨牙,出牙延迟,萌牙延迟,出牙迟缓,出牙缓慢,多生牙
龋(牙)|K02||牙冷热酸甜刺激感酸痛感,食物嵌塞牙后疼痛|牙色泽变黑,牙黄褐色斑点,龋洞,洞内牙质黄褐色或深褐色|
牙齿硬组织的其他疾病|K03||牙本质过敏,牙髓病,根尖周症状,牙横断,牙龈退缩|楔形缺损,牙釉质变薄|
牙髓和根尖周组织疾病|K04|出血,不敢咀嚼,牙髓息肉,牙石堆积|冷热酸甜刺激后牙疼痛,无自发性牙痛,口臭,牙松动,咬合无力,咬合疼痛,牙周袋溢脓,牙齿叩击痛|牙疼痛剧烈,牙自发性阵发性痛,牙夜间痛,温度刺激牙疼痛加重,牙疼痛不能自行定位,牙体硬组织病史,深牙周袋,咬合创伤,探诊剧烈疼痛,微小穿髓孔,叩痛,牙髓温度增高|
牙髓和根尖周组织疾病|K04|牙髓病史,外伤史,牙髓治疗史|牙痛,牙齿咬合痛,牙齿叩诊痛,牙齿不适感,牙髓活力测试无反应,深牙周袋,不敢咬合,根尖部牙龈潮红,牙松动,牙龈红肿,移行沟扁平,扪诊波动感,牙龈脓包,牙冠变色||
龈炎和牙周疾病|K05|牙龈红色,牙齿缝隙大,齿龈肿痛,齿龈肿胀,牙齿异常,牙齿黑斑,牙齿臭,牙龈痛,牙齿遇冷热痛|牙龈肿胀,牙龈溢脓,牙龈出血||龈炎,牙周疾病,牙龈炎,牙龈脓肿,牙周炎,右下牙龈炎
牙面畸形[包括错颌]|K07||牙齿畸形,颌面畸形,下颌畸形,牙错位|牙齿畸形,颌面畸形,下颌畸形,牙错位,牙列拥挤,牙弓前突,前牙深覆盖,深覆牙合,反牙合,后牙颊舌向错位,开唇露齿,上颌切牙倾斜,前牙对刃牙合,反牙合,开牙合|
牙齿及支持结构的其他疾患|K08|牙周膜炎,牙髓炎,牙出血,牙龈局部肿胀|牙松动,牙疼痛,牙倾斜,妨碍咀嚼|牙折冠折,牙根折,冠根联合牙折,乳牙损伤|
口区囊肿,不可归类在他处者|K09||按压波动,按压面团样感,囊肿占位压迫感,口区囊肿,肿大||皮样囊肿,囊肿,眉弓囊肿,牙龈囊肿,左眉梢囊肿
涎腺疾病|K11|口干,持续性跳痛,舌炎,舌体肥大,味觉减退,腮腺无痛性肿块,脉搏加速,压痛,伸舌偏斜,囊性肿块|张口困难,导管口有脓性分泌物,颌下腺肿胀,胀痛,腮腺区肿大,颌下腺疼痛||涎腺疾病,腮腺炎,化脓性腮腺炎,左侧腮腺炎,右侧腮腺炎,复发性腮腺炎
口炎和有关损害|K12||进食困难|口腔黏膜疼痛,口腔灼痛明显|
唇及口腔粘膜的其他疾病|K13|呼吸道阻塞,口腔粘膜弥漫充血,发热,舌炎,睑裂狭小,呼吸困难,食物返流至鼻腔,张嘴颌骨响,口唇周围鳞状皮肤,上唇肥厚,口咽部水疱状损害,听力减退,进食困难,唇干裂,食欲减退,表皮角化,结节,疼痛,粘膜充血,舌两侧边缘毛状白斑,牙齿小而稀疏,口涎外溢,眼睑浮肿,吞咽困难,皮肤硬化溃疡,脓疱,皮肤干燥,张口困难,说话带鼻音,水肿,口唇充血呈红色,黏膜损害,口角软化,口角湿润,结膜充血,下唇肿胀外翻,声音嘶哑,头疼|口唇皲裂,唇水疱,口唇潮红,口唇渗液,口腔痛,结痂,口腔黏膜溃疡,口唇干燥,溃疡,颌下淋巴结肿大,压痛||唇及口腔粘膜的其他疾病,疱疹性口腔炎,溃疡性口腔炎,口腔炎,口腔溃疡,口角炎
舌疾病|K14|舌粘膜发炎,刺痛,溃疡,舌头圆形红斑|圆形红斑,发音不清,舌发胀,咽部异物感||舌疾病,地图舌,舌炎,舌尖溃疡,乳头炎,舌面发黑
胃-食管反流性疾病|K21|吞咽痛,吐酸,呛咳,胸骨疼痛,胸骨烧灼样痛,反胃,窒息|烧心,反酸,胸骨后疼痛,胃食管反流,胸痛||胃食道反流,胃食管反流,胃食管返流,胃食管轻度反流,贲门松弛
食管的其他疾病|K22|消化不良,体重减轻,贫血|吞咽困难,食物反流,呕吐||贲门失弛缓
食管的其他疾病|K22|营养不良,脱水,消瘦,贫血|烧心,胸骨后或剑突下疼痛,吞咽困难,反流||
胃溃疡|K25|腹胀,厌食,嗳气,反酸|钝痛,灼痛,胀痛,剧痛,饥饿样疼痛|周期性上腹痛或不适,餐后疼痛|
胃炎和十二指肠炎|K29|疲乏,胃痛,寒战,呕血,吞咽痛,上腹不适,吞咽困难,食欲较差,胃部隐痛,胀痛,稀便,进食呕吐,胆汁返流,胃灼热,上腹部痉挛,突发性绞痛,胸骨烧灼样痛,消瘦,胃痉挛,腹泻,反酸,口苦,压痛,胃酸减少,体重减轻,厌食,腹部疼痛,肚子疼|发热,上腹部疼痛,恶心,食欲不振,腹胀,呕吐,胃粘膜充血||十二指肠炎,慢性非萎缩性胃炎,胃炎,急性胃炎,胆汁反流性胃炎,慢性非萎缩性胃窦炎
消化不良|K30|反酸,饱胀,上腹部疼痛,厌食,胀气|食欲不振,上腹胀,胃痛,嗳气,恶心||消化不良,纳差,消化功能紊乱
未特指的阑尾炎|K37|腹肌紧张,皮肤感觉过敏|脐周疼痛,发热,恶心,右下腹痛,呕吐,阑尾炎|右下腹压痛|阑尾炎
腹股沟疝|K40|尿频,腹部钝痛,腹部酸胀感,腰背持续隐痛,咳嗽,腰部疼痛,呼吸困难,腹股沟闭孔处肿胀,口唇麻木,腹内压升高,呼吸急促,下腹胀痛,胃肠气胀,排便困难,胀痛,腹痛,便秘,坠胀感,食欲减退,隐痛,巨大的结肠,尿急,腹部肿块,粪便量少,臀部疼痛,恶心,呕吐,腹胀,腹股沟疼痛,下腹疼痛,腹股沟肿块,压痛,胸痛,胸骨隆凸,腹部不适|阴囊肿块,阴囊下坠,阴囊肿大|腹股沟区可复性肿块|腹股沟疝,右侧腹股沟斜疝,左侧腹股沟斜疝,腹股沟斜疝,腹股沟疝,双侧腹股沟斜疝
脐疝|K42|肚脐周围膨胀,发热,呕吐,肚脐周围肿块,脐突,脐部肿物脱出,哭闹,腹部不适|脐部膨出包块||脐疝,疝气,右侧脐疝
膈疝|K44|呼吸困难,紫绀,循环障碍,腹痛,呕吐,腹胀,停止排气排便|肺部发育不良,胸闷,气促,呕血,便血,返流,胸骨后烧灼样疼痛||
其他非感染性胃肠炎和结肠贺|K52|腹部不适,寒战,粪便黑色带血,四肢发冷,粪便量多,口唇泛黑,肠痉挛,胃肠道功能不好,毒血症,溃疡,泡沫样稀便,腰酸,黏液便,水肿,排便频率异常,食欲减退,便血,压痛,肚脐疼,体重减轻,黑便,肚子疼,右上腹疼痛|疲乏,发热,恶心,呕吐,腹泻,腹胀,肠鸣,腹痛||其他非感染性胃肠炎和结肠贺,腹泻,肠炎,急性胃肠炎,迁延性腹泻,急性肠炎
麻痹性肠梗阻和不伴有疝的肠梗阻|K56|肚子疼,发热,粪便中查见虫卵,心跳快,腹部绞痛,呼吸困难,右上腹绞痛,肠梗阻,面色苍白,肠鸣音亢进,肿胀,排便困难,食欲不振,左上腹痛,停止排气,便秘,排便障碍,消瘦,无法排气,右下腹肿块,腹泻,便血,口渴喜饮,脓血便,腹部肿大,腹部肿块,右上腹疼痛,肠鸣音消失,痉挛|恶心,腹胀,呕吐,不排便,不排气,腹痛,直肠狭窄||肠套叠,肠梗阻,乙状结肠冗长,乙状结肠冗长症,不全性肠梗阻,肠麻痹
肠易激综合征|K58|双下肢皮损|腹胀,肠痉挛,腹痛||肠易激综合征,肠痉挛
其他功能性肠疾患|K59|食欲下降,排便障碍,出血,粪便硬结,粪便羊粪状,拒食,排便时间长,稀便,直肠疼痛,黑便,便秘|便血,大便干结,恶心,排便困难,腹胀,呕吐,腹痛||便秘,肠功能紊乱,菌群失调,巨结肠,功能性便秘
肛门及直肠区的裂和瘘|K60||排便时有烧灼样疼痛,排便时有刀割样疼痛,畏惧排便,便血,便秘,肛门瘙痒,排便不畅|肛瘘,肛裂|
肛门和直肠区脓肿|K61|发热寒战,体温升高|大便秘结,排尿不畅,成里急后|肛门周围有小硬块或肿块,继而疼痛加剧,红肿发热,肛周皮下脓肿疼痛,肛周皮下脓肿胀痛|
肛门和直肠的其他疾病|K62|疲乏,寒战,肛门有裂口,坐立不安,无法控制排便,出血,皮肤潮红,刺痛,组织突出肛门,肛门边缘有肿块,肛旁脓肿,排粪时肛门灼痛,肛门胀痛不适,肛内隐痛坠胀,直肠肛门内胀痛不适,直肠流粘液,黑便,肛门病变,肛门红肿,腹部痉挛,直肠充盈肛门阵发性钝痛,大便时出血,肛门松弛肛门剧痛,肛周肿胀,直肠流血,溃疡,脓疱,不适感,排便障碍,直肠痛,排便频率异常,瘙痒,排便不尽感,压痛,肛门钝痛|便秘,发热,肛门疼痛,里急后重,腹泻,便秘,便血,肛周疼痛,排便疼痛,直肠肛门胀痛不适,肛门坠胀,排便疼痛||肛裂,肛周脓肿,肛周炎,肛瘘,肛门狭窄
肠的其他疾病|K63||脱水,营养不良,外伤史,开腹手术史||
肠的其他疾病|K63||慢性腹泻,慢性肠道感染||
腹膜炎|K65|发热,水肿,失水,电解质紊乱,贫血,全身中毒现象,休克|持续性剧烈腹痛,腹肌紧张,腹部压痛,反跳痛,腹膜刺激征,腹式呼吸受限制||
腹膜的其他疾患|K66|||腹部胀满,摸到腹部包块|
肝衰竭,不可归类在他处者|K72|呕吐,腹水,食欲减退,蜘蛛痣,牙龈出血,面色晦暗,乏力,浮肿,厌油|皮肤黄染,恶心,鼻出血,尿色进行性加深||肝衰竭,不可归类在他处者,肝功异常,肝功能异常,肝功损害,肝功损伤,肝功受损
其他炎性肝脏疾病|K75|发热,消瘦|吐奶,厌食,体重不增,腹胀|黄疸,肝脾大,尿色加深|
肝的其他疾病|K76|发热,消瘦|腹痛,腹胀,腹部包快,肝大,黄疸,腹水|右上腹部疼痛,上腹部饱腹感|
肝的其他疾病|K76|水肿,虚弱乏力,食欲减退,少尿,无尿|脾肿大,上消化道出血,腹水,肝炎病史,黄疸病史,黄疸,手掌发红,肝掌,胸前有蜘蛛痣,腹壁静脉曲张||
胆石症|K80|寒战,高热|剑突下及右上腹部绞痛,阵发性发作腹痛,持续性腹痛阵发加剧,右肩部放射性疼痛,腹痛,弛张热,寒战,高热,黄疸,恶心,呕吐|Charcot三联症|
胆道的其他疾病|K83|皮肤瘙痒|皮肤瘙痒,肝肿大,脾肿大,白陶土样大便,脂肪泻,皮肤粗糙,色素沉着,夜盲症,骨软化,骨质疏松,出血倾向,黄瘤|黄疸|
急性胰腺炎|K85|休克|腹部剧烈疼痛,腹痛,腹胀,恶心,呕吐,发热,背痛||
消化系统的其他疾病|K92|疲乏,出冷汗,烦躁不安,肠出血,粪样呕吐物,面色苍白,心悸,呼吸急促,心率增快,大便呈褐色,上腹部疼痛,突发性绞痛,黏液便,头晕,粪便黑色,排水样血性大便|腹泻,便中带血,消化不良,呕血,黑便,便秘||消化系统疾病,胃肠功能紊乱,血便,大便带血,呕血,消化道出血
葡萄球菌性烫伤样皮肤综合征|L00|畏寒,发热,乏力,周身不适,食欲减退|脓疱,结节,痂,水肿性红斑,疼痛,寻常狼疮,疣状皮肤结核,结核样型,瘤型|脓疱疮,毛囊炎,疖和痈,丹毒和蜂窝织炎,皮肤结核,麻风|
脓疱病|L01|发热,淋巴结肿大,压痛,皮温升高,丘疹|脓疱,斑疹含脓性液体,结痂,疱疹含脓性液体,皮疹,溃疡,瘙痒||脓疱病,脓疱疮,新生儿脓疱疮
蜂窝织炎|L03|寒战,四肢发冷,颌骨膨胀,脓性分泌物,关节疼,皮肤光滑,肿胀,手指尖痛,手指触痛,皮肤发红,畏寒,指甲异常,皮肤红肿,结节,压痛,感染性发热,脓液,指甲皮破裂,头疼,脸部疼痛|脓疱,发热,皮肤弥漫性红肿,恶寒,淋巴结肿大,疼痛||蜂窝织炎,甲沟炎,左下肢蜂窝组织炎,蜂窝织炎,面颊蜂窝织炎,面部蜂窝织炎
急性淋巴结炎|L04|淋巴结疼痛,淋巴结红肿,发热,压痛|淋巴结肿大,淋巴结压痛||急性淋巴结炎,颈部淋巴结,化脓性颈部淋巴结炎,双侧颈部淋巴结炎,右侧颈部淋巴结,左耳前急性化脓性淋巴结炎
皮肤和皮下组织其他局部感染|L08|坏疽,蜂窝组织炎|皮肤疖痈,皮肤感染,皮肤疼痛,毛囊炎||皮肤和皮下组织其他局部感染,皮肤感染,感染性皮疹,肛周感染,脐部感染,化脓性脐炎
类天疱疮|L12|疲乏,发热,表皮坏死,黏膜损害,水疱,大疱,睑内翻,口周脓痂,体重减轻|丘疹,水疱,大疱损害,瘙痒||类天疱疮,脓疱疹,脓疱疮
尿布皮炎|L22|皮肤肿胀,红斑样皮疹,口角生疮,烦躁不安,皮肤潮红,肿胀,哭闹不安,皮疹,疱疹,口腔痛,脓疱,皮肤发红,嘴里白色斑块,舌头白色斑块,脓液,口腔粘膜白色斑块|尿布部位红斑,溃疡,臀部皮肤粗糙发红,丘疹||尿布皮炎,尿布疹,预防尿布疹
变应性接触性皮炎|L23|流脓,皲裂,皮肤干燥,肿胀,皮肤弥漫性红肿,丘疹|皮肤瘙痒,渗液,发热,皮肤潮红斑块||变应性接触性皮炎,过敏性皮炎,接触性皮炎,左侧足背过敏性皮炎
内服物质引起的皮炎|L27||皮肤肿胀,嗓子痒,误服药物,口唇发麻,食物过敏,皮疹,喉咙发紧||内服物质引起的皮炎,牛奶蛋白过敏,食物过敏,牛奶过敏,CMPA,牛奶
慢性单纯性苔癣和痒疹|L28|斑疹,红斑样皮疹,指甲呈筒形,全身弥漫性潮红,流血,口角生疮,斑块,出血,脚趾甲内长,中指指甲凹陷,脓疱,趾甲凸起,血疱,指甲凸起,外阴瘙痒,结节性损害,皮肤灼热,流脓,阴囊瘙痒,针尖大小的角化丘疹,皮肤湿疹,出血性丘疹,皮肤瘙痒,淋巴结肿大,色素异常|丘疹,瘙痒,结节,四肢苔藓样变,风团|外阴鳞状上皮增生,会阴皮肤暗红或粉红或白色,苔藓样变,皮革样增厚,粗糙隆起,抓痕皲裂溃疡,外阴硬化性苔藓,小丘疹,皲裂脱皮,羊皮样改变,阴道口挛缩狭窄|慢性单纯性苔癣,痒疹,丘疹性荨麻疹,外阴慢性单纯性苔藓,慢性单纯性苔藓,外阴硬化型苔藓,外阴苔藓
其他皮炎|L30|发热,咳嗽,脱屑,视网膜水肿,水疱,大疱损害,眼睑肥厚,皮肤增厚,虚汗,皮肤损害,手上有小水泡,皮肤湿疹,结节,出血性丘疹,视物模糊,皮肤水疱,皮肤湿毒,斑疹,皮肤剥落,视力异常,皮肤浸润,斑块,恶心,呕吐,潮红潮热,肿胀,皮疹,腹壁红斑,溃疡,疱疹,脓疱,皮肤出现脱落,红色盲,皮肤干燥,皮肤皲裂,关节痛,嗜睡,黏膜损害,瘙痒,皮肤瘙痒,紫癜,汗出如油,淋巴结肿大,瘀斑,头疼,皮肤硬化|眼睑瘙痒,红斑鳞屑,红斑样皮疹,皮肤瘀点,皮肤发红,丘疹,皮肤轻度糜烂||湿疹,虫咬性皮炎,包皮炎,肛周皮炎,皮炎,异位性皮炎
荨麻疹|L50|全身皮肤充血,皮肤发红,红斑样皮疹,打喷嚏,丘疹,呼吸困难,周身不适,食欲减退,吞咽困难,皮肤瘙痒,皮肤水疱,皮肤有压痕,淋巴结肿大|疲乏,发热,恶心,呕吐,瘙痒,水肿性红斑,头疼,风团||荨麻疹,丘疹样荨麻疹,急性荨麻疹,慢性荨麻疹,丘性性荨麻疹
甲疾患|L60|脚趾红肿,趾甲变薄,变形,浑浊,易碎疼痛|甲板无光泽,指甲易碎,甲板切迹,甲板纵嵴,甲板变薄,甲板变厚,甲横断||甲疾患,甲营养不良,趾甲角化不良,甲床营养不良
其他非瘢痕性毛发缺失|L65|眉毛细,眉毛稀疏,全秃,丘疹,结节,脱发,色素异常|毛根松动,毛发异常||毛发缺失,脱发,局部脱发,毛发增多,脂溢性脱发,毛发脱落
毛色和毛干异常|L67|白发|毛发异常||毛色异常,毛干异常,白发,头发白
痤疮|L70||脓疱,黑头,囊肿,结节,炎性丘疹,白头,粉刺||痤疮,面部痤疮,痤疮,面部及背部痤疮,面部背部痤疮
其他毛囊疾患|L73|干燥结痂,四周红晕|毛发周围红色丘疹,毛发周围丘疹性脓疱,毛囊性脓疱||毛囊疾患,毛囊炎,化脓性毛囊炎,皮脂腺样皮疹,周孕外阴毛囊炎,皮脂腺
白癜风|L80||白斑,毛孔周围岛状色素|一片或几片色素减退斑,境界清楚的色素脱失斑,乳白色斑点,白癜风|
色素沉着的其他疾患|L81||咖啡斑,色素痣,晒斑,老年斑,太田痣,雀斑,皮肤色素沉着,黄褐斑,色素性毛表皮痣||皮肤色素脱失,皮肤色素沉着,食物性色素沉着,色素沉着,皮肤咖啡牛奶斑
皮肤萎缩性疾患|L90||皮肤萎缩,面部萎缩|瘢痕,疤痕,瘢痕挛缩,瘢痕粘连,手术后瘢痕,瘤样瘢痕,瘢痕疙瘩,皮肤赘生物|
红斑狼疮|L93|发热,疲劳,乏力,体重减轻,贫血,腹痛,腹泻,恶心,呕吐|淋巴结肿大,脾肿大,红斑或丘疹,口腔,外阴溃疡,鼻溃疡,脱发,雷诺现象,网状青斑,动静脉栓塞,反复流产|蝶形红斑,盘状皮损,皮肤对光过敏|
皮肤和皮下组织的其他疾患,不可归类在他处者|L98|畏寒发热,乏力,食欲缺乏,关节疼痛|斑疹,斑块,丘疹,风团,水疱和大疱,脓疱,结节,囊肿,糜烂,溃疡,鳞屑,浸渍,裂隙,瘢痕,萎缩,痂,抓痕,苔藓样变|瘙痒,疼痛,烧灼,麻木感,皮肤损害|
化脓性关节炎|M00|全身炎症反应,谵妄昏迷|关节屈曲,外伤史,起病急骤,寒颤,高热可达39℃|关节红,肿,热,痛,关节腔积液|
其他类风湿性关节炎|M06|指端坏疽,皮肤溃疡|晨僵,类风湿结节|关节肿胀,持续性关节游走性疼痛,天鹅颈症,钮扣花症|
幼年型关节炎|M08|关节痛,持续发热|全身症状,两侧对称关节稳定病变||
其他关节炎|M13||关节肿胀,关节疼痛|关节活动受限|
髋关节病|M16|关节积液,软骨磨损,髋关节活动受限,关节变形|一侧腿短,大腿皱褶,臀部皱褶|一侧髋关节伸展受限|髋关节病,先髋
四肢其他后天性变形|M21|短指,外八字,内八字,扁平足,巨指,X型腿,腿部畸形,腕关节向掌侧移位,掌屈畸形,手腕短缩|X形腿,足内翻,O型腿,内翻足,多指||四肢其他后天性变形,X型腿,生理性膝内翻,O型腿,生理性膝外翻,内八字
其他特指的关节紊乱|M24|0|外伤史,患处疼痛,患处运动受限||
其他关节疾患,不可归类在他处者|M25|疲乏,皮肤斑丘疹,关节僵直,晨僵膝关节肿大,颞部疼痛,下肢外展,关节响痛,风寒湿痹,色素沉着,食欲减退,关节肿胀,踝关节疼痛,肩关节痛,间歇性跛行,关节僵硬,咽痛,白细胞增多,对称性肿胀,背痛,吞咽困难,食欲不振,滑膜发炎,溃疡,脓疱,指节增粗,头晕,畏寒,腰背痛,月板受损,腰骶疼痛,肝脾肿大,色素异常,头疼|发热,关节交锁,关节韧带损伤,丘疹,肌肉关节疼痛,关节肿痛,月板受损,皮疹,淋巴结肿大,肝脾肿大,关节韧带撕裂||JIA,幼年特发性关节炎,JRA,类风湿关节炎,类风湿性关节炎
结节性多动脉炎和有关情况|M30|疲乏,水疱,眼结膜充血,紫癜,淋巴结肿大,咽黏膜充血|口唇干燥皲裂,斑丘疹,发热,结膜充血,颈部淋巴结肿大||川崎病
系统性红斑狼疮|M32|管型尿,夜尿增多,关节肿痛,肌肉酸痛,疲惫无力,盘状红斑,紫绀,肝脾肿大,肌性肌无力,溃疡,间歇性跛行|面部蝶形红斑,发热,斑疹,甲周红斑,关节痛,肌肉疼痛||系统性红斑狼疮,狼疮性肾炎,系统性红斑狼疮,SLE,系统红斑狼疮,狼疮性肾炎IV型
皮多肌炎|M33|疲乏,发热,斑疹,呼吸困难,说话困难,钙沉积,肌肉僵硬,食欲不振,皮疹,皮下组织硬结,双上眼睑紫红色斑,关节痛,喉肌无力,关节挛缩,肌肉疼痛,体重减轻,厌食,头疼,体重下降|吞咽困难,肌肉压痛,肌肉酸痛,眼睑的水肿性紫红色斑,乏力,肌性肌无力||皮多肌炎,皮肌炎,幼年皮肌炎,幼年性皮肌炎,幼年皮肌炎转移性钙化
结缔组织的其他系统性受累|M35||发热,,球蛋白增高,类风湿因子阳性,关节痛,血管炎,血沉增快||结缔组织病,结缔组织疾病,大便干燥,干燥综合征,混合结缔组织病,白塞氏病
脊柱侧弯[脊柱侧凸]|M41|厌食,低热,乏力,消瘦,心肺功能异常,肺活量低,活动后胸闷,气促|背部肌肉酸痛,长期低热,高热,关节痛,外周关节炎症,外周关节急性炎症|腰骶疼痛,脊柱中线偏向一侧呈C或S形,双肩不等高,背部左右不平|
其他变形性背部病|M43|颈部疼痛,颜面部畸形,斜颈畸形,体型异常,颈部肿块,颈部肌肉肿胀|颈部僵硬,头部活动受限||变形性背部病,斜颈,习惯性斜颈,肌性斜颈,右侧斜颈,右侧肌性斜颈
脊椎关节强硬|M47|肌背肌发育不对称|颈椎间隙炎症,颈椎间隙水肿,恶心,心慌|头疼,头晕,头皮发麻,颈肩肌肉疲劳,颈椎小关节错位|
背痛|M54|臀部疼痛,脚无力,腰骶部疼痛,腰椎膨出,腰脊椎疼痛,慢性腰痛,肾气虚,刺痛,肾阴虚,上肢疼痛,胀痛,下腰部疼痛,腰部僵直感,腰背刺痛,剧烈运动后腰痛,肌肉萎缩,下肢麻痛,麻木感,下背部酸痛,腿无力,腰部酸胀及无力,右腰部压痛|下肢放射痛,腰背酸痛,腰骶疼痛,背痛,放散至大腿内侧疼痛||背痛,腰痛,经期腰痛,腰骶部痛,腰腹胀痛
滑膜炎和腱鞘炎|M65|发热,肌肉硬结,膝关节肿大,肿胀,腱鞘厚化,足踝滑圆形包块,滑膜发炎,干燥结痂,踝膝关节积液,肌损伤,滑膜增厚,关节液增加,膝及小腿瘀血斑,关节出血,拇指疼痛,腱反射异常,肌肉酸痛,桡骨茎突剧痛,疼痛|关节痛,关节肿胀,关节活动受限||滑膜炎,腱鞘炎,滑囊炎,扳机指,髋关节滑膜炎,腱鞘炎,左侧髋关节滑膜炎,腱鞘囊肿
其他软组织疾患,不可归类在他处者|M79|脂肪萎缩,神经痛,四肢肿胀,软组织疾患,风湿|腿痛,肌肉肿胀,下肢肿胀||软组织疾患,不可归类在他处者,腿痛,左下肢肿胀,右下肢肿胀,膝盖痛,下肢肿胀
骨密度和结构的其他疾患|M85|骨膜反应,骨质增厚|外伤史,病理性骨折,患肢疼痛,患肢肿胀,患肢功能障碍|骨囊性包块,囊肿压痛,囊肿疼痛,囊内黄色液体,囊内褐色液体,囊内透明液体|
骨髓炎|M86|局限性压痛,肿胀,全身中毒症状|恶寒,高热可达39℃,呕吐,脓毒症状|胫骨上段,股骨下端多见,患肢剧痛,患肢半屈曲状,周围肌肉痉挛,局部皮肤红肿热痛,软组织深部脓肿|
骨坏死|M87|髋关节附近肌挛缩,大腿肌萎缩,小腿肌萎缩,肢体缩短,畸形|外伤史,伤后可急性发作疼痛,跛行明显,髋关节周围时有压痛点,髋关节有疼痛感,4字实验阳性,髋关节活动受限,大粗隆突出|间歇性跛行,髋关节疼痛,膝关节疼痛,大腿内侧疼痛|
骨的其他疾患|M89|神经痛,放射痛,瘫痪,营养不良|关节压痛,关节僵硬,活动不便,行动不便|关节疼痛,关节肿胀,关节麻木,骨刺|
肌肉骨骼系统和结缔组织的其他后天性变形|M95|圆形削肩,颈向前伸,腹部凸出,呼吸困难,罐状腹,心慌,不好动,吸气性喘鸣,气短,体形瘦弱|胸廓变形,驼背||肌肉骨骼畸形,漏斗胸,鸡胸,胸廓畸形,先天性漏斗胸,轻度漏斗胸
急性肾炎综合征|N00|全身不适,乏力,食欲不振,发热,头痛,头晕,咳嗽,气急,恶心,呕吐,腹痛,淋巴结肿大,炎症渗出,鼻出血|水肿,高血压,充血性心力衰竭,呼吸困难,端坐呼吸,颈静脉怒张,频咳,咳粉红色泡沫痰,两肺布满湿罗音,心脏扩大,奔马律,肝肿大,水肿加重,剧烈头痛,复视或一过性失明,惊厥,昏迷,尿少,尿闭,急性肾功能不全|呼吸道及皮肤感染,血尿,蛋白尿,尿量减少|
复发性和持续性血尿|N02|水肿,高血压,肾功能正常或轻度减退|轻度或无蛋白尿,血尿|感染,血尿,肉眼血尿,镜下血尿|
肾病综合征|N04|食欲减退,蛋白质摄入不足,吸收不良,易感染,高凝,微量元素缺乏,内分泌紊乱,免疫功能低下,动脉硬化,贫血,呼吸困难|水肿,高脂血症,腰痛,肋腹痛,血尿,高血压,肾功能减退|大量蛋白尿,低蛋白血症|
梗阻性和反流性尿路病|N13|疲乏,少尿,尿瘘,恶心,尿灼烧感,呕吐,夜尿增多,肾盂积水,腹泻,蛋白尿,脓尿,血尿,肾部积水现象|发热,尿痛,尿频||梗阻性和反流性尿路病,左肾积水,肾积水,右肾积水,膀胱输尿管反流,双肾积水
慢性肾病|N18|疲乏,尿中红细胞,恶心,呕吐,血浆胆固醇高,夜尿增多,尿中见血,生长缓慢,全身性血管损害,容易疲劳,下肢水肿,尿液大量泡沫头疼,血压高|多尿血尿,全身水肿,少尿,低热,蛋白尿增多,食欲不振,腹痛,腰痛||慢性肾病,肾病综合征,IgA肾病,NS,肾病,肾炎
未特指的肾衰竭|N19|休克|肾盂积水,肾实质性萎缩,尿路梗阻|无尿,少尿,尿量减少|
肾和输尿管结石|N20|发热|尿频,尿急,尿痛,肾盂积水,感染|腹部疼痛,血尿,无尿,少尿,感染发热,排石症状|
下泌尿道结石|N21|消化道伴随症状,腹痛,呕吐|肾区疼痛,血尿,无尿,少尿,感染发热,排石症状,尿频,尿急,尿痛,肾盂积水,下腹疼痛,下腹疼痛向会阴部放射,尿流中断,排尿困难,尿流变细,尿滴沥,急性尿潴留,终末性血尿,排尿困难,尿滴沥,血尿,排尿痛,阴茎痛,急性尿潴留,脓尿,尿道瘘,尿频,尿急,尿痛|肾结石,膀胱结石,输尿管结石,尿道结石|
肾小管功能损害所致的疾患|N25|昏迷,智力发育迟缓|多尿,烦渴多饮||肾小管功能损害所致的疾患,肾小管酸中毒,远端肾小管酸中毒,肾性尿崩症,肾功能损害,肾小管酸中毒I型
肾和输尿管的其他疾患,不可归类在他处者|N28|无肉眼血尿,轻度高血压,低磷性佝偻病,肾性糖尿,氨基酸尿,酸中毒|凹陷性水肿,腹腔积液或胸腔积液,短暂的镜下血尿,肌酐清除率下降,急性肾衰竭|尿量减少,尿色变深|
膀胱神经肌肉功能不良,不可归类在他处者|N31||便秘,大便失禁,会阴部感觉麻木,肢体麻木|尿急,尿频,夜尿,尿失禁,遗尿,排尿困难,膀胱排空不全,尿潴留,生殖器区敏感,性欲异常|
膀胱的其他疾患|N32||急迫性尿失禁|尿急,尿频,夜尿增多,逼尿肌过度活动|
尿道炎和尿道综合征|N34|乳糜尿,膀胱湿热尿血,外阴下坠,尿流缓慢,,尿道刺痒,异常分泌物,下腰部疼痛,下腹疼痛|排尿灼烧感,排尿刺激感,尿痛,尿频,尿道脓性分泌物,尿急||尿道炎,尿道综合征,尿道口炎,尿道炎,尿道综合征,尿道旁腺脓肿,化脓性尿道口炎
尿道的其他疾患|N36|截瘫,神经源性膀胱|肾积水,肾功能下降|尿频,尿急,尿痛,脓尿,尿路结石,尿路感染,肿瘤,尿道狭窄,血尿,无尿,少尿,尿滴沥|
泌尿系统的其他疾患|N39|疲乏,发热,寒战,尿频,肝区肿大,肾脓肿,阴茎疼痛,阴茎硬结,神经质,腰部钝痛,胁腹痛,血尿,下腹疼痛,肾区叩击痛,消瘦,多尿,嗜睡,急性贫血,焦虑|尿急,尿频,尿痛,耻骨上方压迫感,尿色浑浊,排尿不畅,排尿灼烧感,排尿困难|压力性尿失禁,不自主溢尿,排尿后膀胱区胀满感,咳嗽溢尿|尿路感染,压力性尿失禁,张力性尿失禁,尿失禁,无症状性蛋白尿
鞘膜积液和精子囊肿|N43||阴囊有下坠感,牵拉感或胀痛,若积液巨大,阴茎缩入包皮内,排尿异常|阴囊内有囊性肿块,呈慢性无痛性逐渐增大|
睾丸扭转|N44|腹痛,呕吐,发热,可产生睾丸萎缩|精索扭转,精索增粗,精索缩短,睾丸可提向上方,睾丸可横位,阴囊疼痛发作史|睾丸疼痛,睾丸持续疼痛,睾丸疼痛阵发性加重,阴囊红肿,阴囊压痛|
男性不育症|N46||畸精,少精,精子质量差,男性不育,弱精,无精,精液异常||男性不育症,不育症,无精症,畸精症,严重少弱精,丈夫少弱精症
包皮过长、包茎和嵌顿包茎|N47|时常遗精|尿道口狭窄,尿液不易排尽,引起包皮炎,阴茎红肿,阴茎发炎|包皮长,包皮遮挡阴茎头,不能上翻至阴茎冠状沟,包皮口狭窄,包皮与阴茎头粘连|
阴茎的其他疾患|N48|疲乏,发热,丘疹,脓性分泌物,出血,包皮粘连,阴茎阴囊水肿|阴茎疼痛,尿道口红斑和水肿,龟头瘙痒|龟头红肿,包皮分泌物增多,龟头疼痛,阴茎肿胀|阴茎,包茎,包皮过长,包皮垢,阴茎炎,包皮龟头炎
良性乳腺发育不良|N60|||乳房小,乳房扁平,胸部扁平,胸平,乳房不对称,经前乳房胀痛,乳腺囊肿,乳腺|
乳房炎性疾患|N61|发热,寒战,腋窝淋巴结肿大|乳房胀痛,乳房发红发热,乳头溢液,乳房压痛|乳腺肿块和乳头内陷,乳头溢液,乳腺疼痛,乳腺瘘管,窦道或者溃疡,经久不愈|乳腺包块,乳腺炎,右侧乳房蜂窝组织炎,右侧乳腺炎,乳腺红肿
未特指的乳房肿块|N63|||乳房肿块,乳房结节|
乳房的其他疾患|N64|乳房硬结,乳房胀痛,乳房增大,周期性疼痛|乳房包块|乳头皲裂,乳头溢液,乳房下垂|乳房胀痛,乳房痛,乳房疼痛,乳房增大,乳房硬结
输卵管炎和卵巢炎|N70|尿频,尿急,尿痛|外阴瘙痒或疼痛,阴道黏膜充血,出血斑,部分滴虫性阴道炎可有,草莓样宫颈|白带增多,泡沫状或豆腐渣样白带,有异味,鱼腥味,臭味,,外阴,阴道瘙痒|
宫颈炎性疾病|N72|外阴瘙痒,灼热感,尿频,尿急,尿痛|不规则阴道流血,子宫内膜炎,盆腔炎,下腹不适,腰骶部疼痛|流产后感染,产褥感染,宫颈损伤等所致宫颈感染,白带增多,脓性白带,宫颈充血水肿,糜烂,流脓,触痛,触之易出血|
其他女性盆腔炎性疾病|N73|寒战,月经不调,宫颈充血,腹痛,月经稀少,腰痛,阴道不规则出血,月经不调,头痛,脓性白带,阴道瘙痒,食欲不振,下腹坠胀,盆腔痛,月经量多|发热,输卵管粘连,宫颈充血,阴道分泌物增多,宫颈触痛,白带增多,腰骶部酸痛,下腹疼痛,脓性白带,白带增多,子宫压痛,腰痛,查体,宫颈充血水中,黏膜外翻,分泌物黏液脓性||宫颈炎,慢性宫颈炎,盆腔炎,宫腔粘连,盆腔包块
前庭大腺[巴多林腺]疾病|N75|疼痛,外阴烧灼刺激感,淋巴结肿大,外阴下坠感,瘙痒|阴唇肿块椭圆形,大小不等,尿痛,外阴肿胀||巴多林腺,前庭大腺囊肿,前庭大腺脓肿,前庭大腺炎
阴道和外阴的其他炎症|N76|发热,淋巴结肿大,脓血性白带,会阴部溃疡|白带增多,外阴瘙痒|VVC,重度瘙痒烧灼感,白色豆腐渣样分泌物,阴道粘膜水肿红斑,BV,白色均质腥臭味分泌物,无或轻度瘙痒,滴虫,稀薄脓性泡沫状分泌物,阴道粘膜散在出血点,轻度瘙痒|阴道炎,BV,VVC,外阴瘙痒,外阴炎
子宫内膜异位症|N80|疼痛,排便痛,触痛,结节,皮肤触痛,腹痛,月经量多,腹部不适,其他部位异位,周期疼痛,出血,肿块|月经不调,经量增多,经期延长,月经淋漓不尽,经前期点滴出血,,腹部结节,不孕,40,,,痛经,继发性进行性加重,,异位病灶破裂有恶心,呕吐,肛门坠胀感|继发性进行性加重的痛经,慢性盆腔痛,查体有与子宫相连的囊性包块,盆腔触痛性结节|子宫内膜异位症,子宫腺肌症,巧囊,EMS,盆腔占位,腺肌症
女性生殖器脱垂|N81|性交痛,脓性分泌物,黏液便,尿急,白带增多,便血,排便困难,下背部痛,直肠疼痛|腰骶部酸痛,尿频,尿急尿痛,压力性尿失禁,排尿困难,排便困难,尿路感染,宫颈阴道壁溃疡出血|阴道充盈,宫颈突出阴道外|女性生殖器脱垂,子宫脱垂,POP,阴道前壁膨出,阴道前壁轻度膨出,阴道前后壁膨出
卵巢、输卵管和阔韧带的非炎性疾患|N83|骨盆疼痛,内出血,腹胀,腹痛,排便痛|下腹部包块,下腹坠胀,月经紊乱,下腹疼痛,破裂时有局部压痛反跳痛||左附件占位,右附件占位,附件占位,宫腔占位,卵巢癌,卵巢囊肿
女性生殖道息肉|N84|肥胖,高血压|经间期出血,使用他莫昔芬,乳腺癌病人|子宫异常出血,经量增多,经期延长|
宫颈发育不良|N87|阴道分泌物增加|阴道流液,可伴异味,宫颈中重度糜烂|妇科检查宫颈接触性出血|
宫颈其他非炎性疾患|N88|宫颈水肿,尿频,闭经,停经,月经不调,阴道坠胀感,骨盆疼痛,白带增多,痛经,脓性分泌物,鳞状细胞化,绝经后出血,子宫小,呼吸急促,下腹坠胀,月经不潮,下腹疼痛,阴道异味,白带增多,子宫出血,腰骶疼痛,阴道瘙痒,子宫压痛,月经量多|白带异常,宫颈锥切,阴道不规则出血,阴道分泌物增多,宫颈闭锁,腹痛,阴道排液增多||宫颈病变,LEEP,子宫全切,宫颈LEEP,宫颈leep
外阴和会阴的其他非炎性疾患|N90|坐立不安,阴部溃疡,丘疹,脱屑,水肿,外阴肿胀,阴部溃疡,疼痛|外阴萎缩,阴道分泌物增多,外阴白斑,外阴烧灼刺激感,外阴瘙痒,外阴下坠感||外阴营养不良,营养不良,外阴白斑,小阴唇粘连,外阴新生物
月经过多、月经频繁和月经不规则|N92|疲乏,恶心,头晕,出血,神经性厌食,食欲不振,头疼|月经周期改变,闭经,月经不调||月经紊乱,停经,月经量少,月经稀发,继发闭经
其他异常的子宫和阴道出血|N93||月经失调,功血,宫颈出血,阴道出血|子宫不规则出血,一般无腹痛或其他不适|阴道出血,阴道流血,同房出血,阴道不规则出血,功血
与女性生殖器官和月经周期有关的疼痛和其他情况|N94|恶心,呕吐,月经期间腰疼,骨盆疼痛,阴道裂伤,腹胀,下腰部疼痛,乳腺胀痛,阴道后穹窿触痛,大腿内侧疼痛,阴道粘连甚至闭锁,经期前乳房痛,头晕,外阴萎缩,经期小腹坠痛,痉挛,头疼,腹泻,乏力|腰骶疼痛,下腹坠胀,痛经,下腹至耻骨痉挛性疼痛,疼痛可放散质腰骶部和大腿内侧|下腹至耻骨痉挛性疼痛|与女性生殖器官和月经周期有关的疼痛和其他情况,痛经,盆腔积液,宫腔积液,原发痛经
绝经期和其他围绝经期的疾患|N95|外阴瘙痒,灼热不适,怕冷,易激动,月经不调,白带增多,排便困难,抑郁,外阴皮肤肿胀,头疼,月经量少,性交痛|怕冷,易激动,无月经来潮,潮热,绝经|绝经|绝经期和其他围绝经期的疾患,围绝经期,老年性阴道炎,绝经后阴道出血,绝经后,绝经后阴道流血
习惯性流产|N96|恶心,呕吐,乏力|腹痛,阴道排出大量血块,宫口松弛,黄体功能不全,子宫肌瘤及甲状腺功能低下等病史|停经史,阴道流血较多|
女性不孕症|N97|闭经,月经紊乱,未避孕未孕,盆腔痛,低热畏寒,白带异常,泌乳,多毛痤疮,肥胖,酗酒|输卵管阻塞,无排卵,同居一年以上未妊娠,不孕|输卵管阻塞,无排卵,同居一年以上未妊娠,不孕|女性不孕症,不孕,原发不孕,继发不孕,不孕症,月不孕
自然流产|O03|恶心,呕吐,乏力,厌食|阴道排出大量血块,宫口松弛,子宫小于相对应孕周|停经史,不同程度阴道流血,下腹痛,胎儿组织物排出|
未特指的流产|O06|停经后阴道流血,下腹疼,痛葡萄胎,内分泌异常,子宫异常增大,药物流产,阵发性下腹痛,妊娠呕吐,阴道流液,阵发性腰背痛,胎盘组织堵塞于宫颈口,免疫功能异常,流产,严重营养缺乏,阴道出血,手术流产,怀孕后腹痛,休克,轻度甲亢,下腹部隐疼,染色体异常,子宫异常变软,阴道出血,怀孕后阴道出血,晕厥,人工流产,清宫,自然流产|清宫,先兆流产,药物流产,人工流产,反复多次流产,手术流产,自然流产,流产|先兆流产,药物流产,人工流产,反复多次流产,手术流产,自然流产,流产|流产,RSA,人流,自然流产史,自然流产后,葡萄胎清宫
妊娠早期出血|O20|恶心,呕吐,低热,眩晕,头痛,失血性休克|停经,腹痛,阴道出血,晕厥,腹部包块,下腹压痛反跳痛,宫颈举摆痛|宫外孕,异位妊娠停经后腹痛阴道流血|异位妊娠,宫外孕,宫外孕史,宫外孕保守,切口妊娠,切口妊娠清宫
为已知或可疑胎儿异常和损害给予的孕产妇医疗|O35||羊水异常,胎心异常,胎儿心脏彩超,宫内发育迟缓,先心病||为已知或可疑胎儿异常和损害给予的孕产妇医疗,胎儿先心病,胎儿心脏咨询,胎儿咨询,胎儿,胎儿CHD
胎盘疾患|O43|低热,眩晕,厌食,头痛|宫口未开,腹痛,恶心呕吐,乏力|停经,胚胎或胎儿已死亡滞留在宫腔未能排出,子宫小于相应孕周,少许阴道流血|
早产|O60|产程延长,产妇烦躁不安,体力衰竭,进食减少,严重者出现脱水,代谢性酸中毒,尿潴留,肠胀气|母亲方面,产妇全身衰竭,子宫收缩异常,胎膜早破,,胎儿方面,胎儿头皮水肿或血肿,胎头下降受阻,胎儿窘迫|产力异常,子宫收缩乏力,子宫收缩过强,,产道异常,骨产道异常,软产道异常,,胎位异常,持续性枕横位,枕后位,胎头高直位,前不均倾,面先露,臀先露,肩先露,复合先露|
产力异常|O62||引产,药物引产,缩宫素,剥膜引产,人工结束妊娠|引产,产力异常|产力异常,引产,引产后,宫颈炎月经紊乱,宫颈松弛,畸胎引产
与分娩有关的乳房感染|O91|发热,寒战,腋窝淋巴结肿大||乳腺炎,乳痛症,乳房肿胀,乳房疼痛,乳房压痛,乳房搏动性跳痛,乳头感染,乳头有脓,乳房脓肿,乳腺炎|
与分娩有关的乳房和哺乳的其他疾患|O92||白色浅黄色乳汁,闭经|溢乳,泌乳,断奶后乳汁分泌,双乳溢乳,轻微溢乳,乳汁少|
妊娠、分娩和产褥期并发症的后遗症|O94||心脏病,心悸,气短,劳力性呼吸困难,端坐呼吸,咯血,胸痛,发绀,胸痛,颈静脉怒张,,病毒性心肌炎,发生妊娠期高血压,产后出血,凝血功能异常,母婴垂直传播等|妊娠合并心脏病,先天下心脏病,风湿性心脏病,妊娠期高血压疾病性心脏病,围产期心肌病,,病毒性肝炎,贫血,缺铁性贫血,巨幼细胞贫血,再生障碍性贫血,,特发性血小板减少性紫癜,急性阑尾炎,急性胰腺炎等|
可归类在他处的孕产妇的传染病和寄生虫病并发于妊娠、分娩和产褥期|O98||阴部瘙痒,表面隆起,疣状增生,淡红色的丘疹|hpv病毒,hpv感染,hpv阳性|妊娠期,分娩期,产褥期,HPV感染,HPV阳性,HPV,hpv感染,宫颈HPV感染
可归类在他处的孕产妇的其他疾病并发于妊娠、分娩和产褥期|O99|宫角妊娠,停经后阴道流血|生化流产,孕早期阴道流血,异位妊娠,腹痛,子宫不对称性增大,宫角妊娠|早孕,停经,晨吐,恶心厌食,尿频,乳晕加深,蒙氏结节|产褥期,宫角妊娠,生化妊娠后,生化妊娠,早期妊娠,妊娠
胎儿和新生儿受母体情况影响,这些情况可能与本次妊娠无关|P00|||新生儿窒息,新生儿缺氧缺血性脑病,HIE,,新生儿呼吸窘迫综合征,新生儿肺透明膜病,,新生儿黄疸,新生儿溶血病,新生儿败血症,新生儿寒冷损伤综合征|
胎儿生长缓慢和胎儿营养不良|P05|代谢异常,生长缓慢,软骨发育不良,皮下脂肪少,适应性差,成骨不全早产,喂养困难,外观不匀称,代谢差,指甲短软,出生体重低,吞咽功能不完善,抵抗力弱,呼吸能力弱|身材矮小,体重低,生长缓慢,出生体重低|宫内生长迟缓,早产|胎儿生长缓慢,胎儿营养不良,早产儿,低体重,SGA,早产,SGA矮小
产伤引起的颅内撕裂和出血|P10|激惹,过度兴奋,淡漠,嗜睡,昏迷|惊厥,瞳孔不对称,对光反应不良,瞳孔固定和散大|脑性尖叫,前卤隆起,角弓反张|
头皮产伤|P12||头皮血肿,头颅血肿|头皮产伤|头皮产伤,头颅血肿,头颅血肿肌化,左顶部头颅血肿,新生儿头颅血肿,双顶部头颅血肿
出生窒息|P21|胎心,,100次/min,持续5,min以上,羊水Ⅲ度污染,Apgar评分1,min≤3分|宫内窘迫史,产时窒息史,脑水肿表现|早期胎动增加,晚期胎动减少甚至消失,胎心异常,羊水粪染,Apgar评分,7分,多脏器缺氧受损,脐动脉血气pH,7,意识改变,昏迷,肌张力减低,惊厥,原始反射减弱或消失,呼吸衰竭,瞳孔改变,脑电图异常|
新生儿呼吸窘迫|P22|||呼吸窘迫进行性加重|
先天性肺炎|P23|精神萎靡,少哭,不哭,呼吸急促,拒乳|口周发紫,鼻煽,呼吸急促,口吐白沫,呛奶||先天性肺炎,新生儿肺炎
新生儿吸入综合征|P24||休克,心衰|分娩时见羊水粪染,新生儿脐带待甲床粪染,口鼻腔内有胎粪,呼吸急促,青紫,鼻翼煽动,三凹征|
起源于围生期的其他呼吸性情况|P28|三凹征,呼吸困难,呼吸衰竭|啼哭,喂养,激动喘鸣音加重|喉软骨软化,吸气性喘鸣,似哨音的鸣响,尖锐刺耳鸡叫|
先天性病毒性疾病|P35|||早产,宫内发育迟缓,小于胎龄,多器官损伤,神经后遗症,听力障碍,黄疸,肝脾肿大,呼吸窘迫,间质性肺炎,小头畸形,脑室周围钙化,脑瘫,癫痫|
新生儿细菌性脓毒症|P36|凝血功能紊乱,免疫功能紊乱,外周血白细胞增加,炎性反应,多器官功能损害,高代谢状态|发热,肝肿大,呕吐,心动过速,呼吸急促,反应差,嗜睡,少吃,少哭|败血症,脓毒症,黄疸,胆红素脑病,肝脾肿大,出血倾向,,皮肤瘀点瘀斑|新生儿细菌性脓毒症,脓毒症,新生儿败血症,新生儿败血症复查,严重脓毒症,新生儿脓毒症
其他先天性传染病和寄生虫病|P37|哺乳困难,哭闹不止|念珠菌感染,口腔粘膜乳白色斑膜,拒绝吃奶|鹅口疮|其他先天性传染病和寄生虫病,鹅口疮,先天性结核病,鹅口疮痊愈
新生儿脐炎伴或不伴轻度出血|P38||脐部溢液,脐部红肿变硬,脐部有分泌物|脐炎|脐炎,新生儿脐炎,轻度脐炎
胎儿和新生儿的溶血性疾病|P55|||黄疸,贫血,肝脾大,血型不合|
其他和未特指原因所致的新生儿黄疸|P59||面部皮肤黄染,巩膜黄染,婴儿肝炎,胆红素代谢异常|新生儿黄疸|黄疸,新生儿黄疸,新生儿高胆红素血症,婴儿肝炎综合征,婴儿肝炎,新生儿病理性黄疸
特发于胎儿和新生儿的暂时性碳水化合物代谢紊乱|P70||反应差,喂养困难,呼吸暂停,嗜睡,哭声异常,颤抖,震颤,惊厥||
暂时性新生儿钙和镁代谢紊乱|P71|||呼吸暂停,激惹,烦躁不安,肌肉抽动,震颤,惊跳,惊厥,手足搐搦,喉痉挛,肌张力增高,踝阵挛阳性,血钙降低|
胎儿和新生儿的坏死性小肠结肠炎|P77|呼吸窘迫,呼吸暂停,嗜睡,体温波动|腹胀,呕吐,胃潴留增加,呼吸衰竭,休克,DIC,死亡,腹膜炎,肠穿孔|大便性状改变,血便,可见肠型,腹壁发红,腹肌紧张,压痛,肠鸣音减弱或消失|
特发于胎儿和新生儿体被的其他情况|P83||保温不足,环境低温|反应低下,吮乳差,哭声地若,活动减少,呼吸暂停,地低体温,皮肤硬肿,橡皮样感,休克,肾衰,DIC|
新生儿惊厥|P90||游走性阵挛,惊厥,抽搐,咀嚼运动,侧肢体惊厥,肢体抽动,肌张力发作性改变,呼吸骤停,持续性眼偏斜|新生儿惊厥|新生儿惊厥,惊厥
新生儿喂养问题|P92||反刍,反胃,呕吐,进食缓慢|拒奶,吐奶|新生儿喂养问题,吐奶,母乳喂养,喂养问题
小头畸形|Q02||小头畸形|小头畸形|小头畸形,小头畸形
脑的其他先天性畸形|Q04||脑室增宽,脑发育异常,脑回异常||脑畸形,脑发育异常,巨脑回,无脑回畸形,左侧脑室增宽,双侧侧脑室增宽,颅脑先天畸形
脊柱裂|Q05|可合并寰枕畸形|下肢感觉功能障碍,下肢运动功能障碍,自主神经功能障碍,膀胱括约肌功能障碍,肛门括约肌功能障碍,背部皮肤缺损,背部囊性肿物,背部囊性肿物压痛,患儿母亲常有孕期外伤史,患儿母亲常有孕期感染史,患儿母亲常有孕期用药史|脊髓膨出,脊膜膨出,脊髓脊膜突出,脊椎发育异常,脊椎椎弓连续性中断,隐形脊柱裂,椎管骨性缺损,显性脊柱裂,棘突椎板缺如|
先天性眼后段畸形|Q14||眼底微血管细胞损害,微血管扩张,微动脉瘤,渗漏,微血管闭塞,视网膜缺血缺氧,眼底新生血管,视网膜脱离,眼底深处,棉绒斑,视网膜水肿,视网膜出血,动脉硬化,视网膜纤维血管增生|糖尿病视网膜病变,高血压性视网膜病变,早产儿视网膜病变|
面和颈部的其他先天性畸形|Q18|发热,咽痛,吞咽困难|一侧颈部红肿疼痛,颈部淋巴结肿大,颈部炎性肿块反复发作||
面和颈部的其他先天性畸形|Q18|||耳朵有漏口,耳朵漏口有液体或脓液流出|
心腔和心连接的先天性畸形|Q20|体重增加缓慢,生长发育差,消瘦|充血性心力衰竭,颈静脉饱满或怒张,颈静脉和肝脏收缩期搏动,心动过速,心律失常,肺血流增多,舒张期杂音|紫绀,杵状指,心脏搏动弥散,第一心音增强,收缩期杂音|
心间隔先天性畸形|Q21||舒张期杂音,劳动呼吸困难|胸骨左缘第3,4肋间可闻,IV,VI级全收缩期杂音伴震颤,P2心音轻度分裂,无明显亢进,杂音伴震颤,舒张中期反流性杂音,P2轻度亢进,劳力性呼吸困难,青紫,呼吸困难,负荷能力下降,杂音减弱,P2亢进|
心间隔先天性畸形|Q21|紫绀,青紫,艾森门格综合征|室上性心律失常,房扑,房颤,右心衰竭|劳力性呼吸困难,随年龄增长症状加重,肺动脉瓣区第二心音亢进呈固定分裂,II,III级收缩期喷射性杂音|
心间隔先天性畸形|Q21|发育迟缓,智能发育落后,活动耐力差,细胞增多症|头痛,头晕,晕厥,抽搐,死亡,心功能不全|青紫,哭闹运动后加重,蹲踞症状,劳累后常取蹲踞位休息,杵状指,阵发性缺氧发作,阵发性呼吸困难,心脏杂音|
心脏的其他先天性畸形|Q24|发育障碍,消瘦,多汗,吸吮无力,拒食,呛咳,疲乏,体力差,红细胞增多症|心功能不全,肺动脉高压,晕厥,咯血,心悸,心衰|紫绀,蹲踞,杵状指,呼吸急促,反复呼吸道感染,心脏杂音|大动脉先天性畸形,先心病,CHD,先天性心脏病,卵圆孔未闭,室间隔缺损,动脉导管未闭,主动脉缩窄,大动脉错位,肺动脉闭锁,主动脉瓣狭窄
大静脉先天性畸形|Q26|乏力,发育不良|心悸,气急,咳嗽,咯血,右心衰竭|紫绀,杵状指,进行性呼吸困难,心脏杂音,胸骨左缘第2-3肋间闻及收缩期杂音|
周围循环系统的其他先天性畸形|Q27||患肢软组织肥厚,患肢胀痛,肢体粗大增长,皮温升高,皮肤红色斑块状血管瘤,多汗,跛行,骨盆倾斜及脊柱侧曲||
周围循环系统的其他先天性畸形|Q27|肢体麻木,蚁走感,常有躯体深,浅感觉障碍,肢体无力逐渐加重,一侧或双侧肢体的完全或不完全瘫痪,大小便失禁|患处短暂性神经根剧痛,呈刺痛或灼痛样,突然头痛,截瘫,颈项强直||
循环系统的其他先天性畸形|Q28|眼球突出,颅内杂音,头痛,恶心,呕吐|脑积水,颅内压升高,颅内血管短路,心衰,脑出血,癫痫|脑出血,头痛,呕吐,意识障碍,癫痫,神经功能障碍|
喉先天性畸形|Q31|喉鸣|呼吸困难,窒息,会厌畸形,环状软骨异常,甲状软骨异常|喉软骨发育不良|喉先天性畸形,喉软骨发育不良,先天性喉软骨发育不良,先天性喉软骨软化病
肺先天性畸形|Q33|发热,咳嗽|呼吸急促,紫绀,反复肺部感染,胸痛|0|
腭裂伴唇裂|Q37|||唇裂,腭裂,唇腭裂,兔唇,腭垂缺失,黏膜下裂,隐裂|
舌、口和咽的其他先天性畸形|Q38||舌头不适,发音困难,咀嚼困难,舌尖W形,舌尖不能上翘|舌头不能自由前伸,伸出部分不及正常儿童的长,舌前伸时舌尖凹陷|
食管先天性畸形|Q39||脱水,消瘦|唾液不能下咽,反流入口腔,出生后即流涎,吐白沫|
000|Q4.||伴发黄疸|见胃蠕动波,扪及幽门肿块和喷射性呕吐|
小肠先天性缺如、闭锁和狭窄|Q41|消瘦,脱水,营养不良,水电解质紊乱,酸中毒,肠穿孔|呕吐,腹胀,不排便,排少量粘液样物|小肠先天性缺如,小肠闭锁和狭窄,大肠先天性缺如,大肠闭锁和狭窄,肠的其他先天性畸形|
肠的其他先天性畸形|Q43|排便异常,喂奶后呕吐|腹胀,不排胎粪,呕吐,便秘|脐茸,巨结肠|肠的先天性畸形,脐茸,先天性巨结肠,先天巨结肠,先天性无肛,先天性巨结肠手术,先天性直肠肛管畸形
胆囊、胆管和肝先天性畸形|Q44|0|黄疸|0|
消化系统的其他先天性畸形|Q45|营养不良,脱水,电解质紊乱,酸碱平衡失调|伸舌样痴呆,食管闭锁,食管气管瘘,美克尔憩室,先天性心脏病,畸形足|完全性十二指肠梗阻,顽固性呕吐,呕吐物中含胆汁,不完全性十二指肠梗阻,间歇性腹痛,呕吐,上腹部饱胀不适,进食后加重|
女性生殖器的其他先天性畸形|Q52||子宫纵膈,双阴道,无宫颈,始基子宫,纵膈子宫,阴道闭锁,病理妊娠,无阴道,无子宫,双角子宫,先天性无子宫双子宫||女性生殖器先天性畸形,纵膈子宫,子宫纵膈,双子宫,子宫纵膈切除,不全纵膈子宫,先天性无阴道
睾丸未降|Q53|腹痛,呕吐,发热|患侧合并腹股沟斜疝,腹部包块|患侧阴囊扁平,左右阴囊不对称,双侧隐睾阴囊空虚,阴囊干瘪,阴囊瘪陷|
尿道下裂|Q54||包皮异常分布,包皮系带缺如,包皮在阴茎头背侧帽状堆积|异位尿道口,阴茎下弯,尿道口位于正常尿道口与会阴部途径上,阴茎畸形|
男性生殖器官的其他先天性畸形|Q55|睾丸扭转,隐匿性阴茎,阴囊错位,睾丸下降不全,阴茎发育不全,阴茎下弯,不育,输精管畸形,尿道下裂,摸不到睾丸,睾丸异位,疝气,尿道口下裂|阴茎包埋,包皮,小阴茎,摸不到睾丸,睾丸下降不全|隐匿阴茎,睾丸发育不良|男性生殖器官先天性畸形,隐匿阴茎,隐睾,右侧隐睾,左侧隐睾,隐匿性阴茎
性别不清和假两性畸形|Q56||真两性畸形,卵巢和睾丸同存,两种性腺组织,不完全阴茎体,尿道下裂,混合型,外生殖器不同程度混合,介于男性女性间|假两性畸形,外生殖器有两性畸形,内生殖器无两性畸形,尿道下裂,女孩出生时出现阴蒂肥大,轻度男性化先天性睾丸发育不全症|
囊性肾病|Q61|肾外囊肿,肝囊肿,脾囊肿,胰腺囊肿,脑底动脉环血管瘤|腹部触诊多囊肾,腹部触诊囊性肾,肾功能缓慢进行性减退|肾脏体积增大,肾表面囊肿,肾区疼痛,腰背部压迫感,腰背部钝痛,血尿,高血压,肾功能不全|
肾的其他先天性畸形|Q63||腹部包块,恶心,腹胀,呕吐,尿少,腰部胀感||肾的先天性畸形,双肾尿盐结晶,先天性肾积水,双肾集合部分离,双肾分离,马蹄肾
泌尿系统的其他先天性畸形|Q64|阴茎短小,后尿道瓣,全身症状,贫血貌,发热|肾积水,尿道梗阻,肾功能下降,巨输尿管症,输尿管扩张,尿道下裂,脓尿,血尿,排尿困难|肾位置异常,肾数目异常,盆腔肾,胸腔肾,肾缺如,单独肾,融合肾,盆腔肾,重复肾,多囊肾,错构瘤,肾血管异常|
髋先天性变形|Q65|单侧脚趾走路|一侧大腿或臀部有多余皱褶,走路有点瘸,髋关节脱位,一侧腿短,髋关节活动受限,一侧髋关节伸展受限|髋关节发育不良|髋先天性变形,髋关节发育不良,先天性髋关节脱位,先天性髋关节发育不良,左侧髋关节发育不良,髋关节发育异常
足先天性变形|Q66|足部肌肉缩短,足部肌肉挛缩|足内翻,足后翻,足部肌肉发育障碍,足部肌肉挛缩|先天性马蹄内翻足,足内翻,足后翻,足似马蹄|
头、面、脊柱和胸的先天性肌肉骨骼变形|Q67||挛缩|小耳,隐耳,招风耳,杯状耳,塌鼻,颅骨凹陷,鼻中隔偏曲,扁鼻,驼峰鼻|
头、面、脊柱和胸的先天性肌肉骨骼变形|Q67|乏力|胸壁前凸,胸廓凹陷,胸骨畸形,肋骨畸形,肋软骨畸形,佝偻病,气促|鸡胸,漏斗胸|
肌肉骨骼的其他先天性变形|Q68|有斜视,髋关节脱位|孩子外观发生变形,面部大小不一致|颈部有异常包块,转动颈部活动受限|
肌肉骨骼的其他先天性变形|Q68||患肢外管畸形,患肢功能障碍|先天性上肢畸形,先天性肩关节脱位,肩胛骨异常移位,先天性尺桡骨联合,前臂旋前功能受限,肘关节内翻畸形,肘关节外翻畸形,先天性下肢畸形,先天性髋关节脱位,走路跛行,走路左右摇摆,下肢缩短,臀部翘起,髋关节弹响,髋关节内翻,膝内翻,站立双膝不能靠拢,膝外翻,站立双踝不能靠拢,马蹄内翻足,扁平足,多趾畸形,缺趾畸形,巨趾畸形,脊柱畸形,移行椎,脊柱发育异常,脊柱裂,胸廓畸形等|
并指[趾]畸形|Q70||手指皮肤短缺,手指血管神经畸形,手指骨骼畸形,手指多出软组织或部分手指或整根手指|两指并连,三指并连,四指并连,五指并连,拇指的桡侧和小指的尺侧多出软组织,拇指的桡侧和小指的尺侧多部分组织,部分骨骼,拇指的桡侧和小指的尺侧多出整根手指|
肌肉骨骼系统先天性畸形,不可归类在他处者|Q79||腹股沟区包块|腹股沟区包块,脐孔出现包块,时大时小的包块|
皮肤的其他先天性畸形|Q82||毛细血管瘤,胎记||皮肤先天性畸形,毛细血管瘤,胎记,皮肤毛细血管瘤,外阴色素痣,横纹肌样瘤
乳房先天性畸形|Q83||乳房不对称,乳房不发育,乳头内陷||乳房畸形,乳房发育不良,乳房发育差,单侧乳房发育,副乳,无乳头
影响多系统的其他特指先天性畸形综合征|Q87|发育迟缓,精神运动性障碍,癫痫发作|先天面容畸形,眼耳畸形|哭时歪嘴,歪嘴哭综合征|歪嘴哭综合征,歪嘴哭综合症,左耳畸形咨询,无意识歪嘴,右侧歪嘴哭综合征
其他先天性畸形,不可归类在他处者|Q89||圆形囊肿,舌骨下囊肿||
唐氏综合征[先天愚型]|Q90|智能低下,皮肤纹理异常|舌伸出口外,流涎多,身材矮小|特殊面容,眼距宽,鼻根低平,眼裂小,眼外侧上斜,内眦赘皮,外耳小|
特纳综合征[性腺发育障碍症][45,X综合征]|Q96|颈侧皮肤松弛,足背明显浮肿,盾形胸,乳头间距增宽,多痣,手外翻,肘外翻,心血管畸形,15,-50,,,马蹄肾或肾发育不全,1/3|身材矮小,生殖器与第二性征不发育,阴毛稀少,无腋毛,外生殖器幼稚型,,体重低||特纳综合征,性腺发育障碍症,45X综合征,性腺发育不良,单纯性性腺发育不良,特纳综合征,XX单纯性性腺发育不良,XY单纯性腺发育不良
其他染色体异常,不可归类在他处者|Q99|染色体异常|染色体异常|女性假两性畸形,外生殖器男性化,闭经,男性假两性畸形,无子宫无阴道,阴茎极小,阴道盲端,无子宫,乳房发育,乳晕苍白,真两性畸形,外生殖器混合型,女性乳房,有勃起阴茎|染色体异常,性发育异常,XY单纯性性腺发育不全,性腺发育异常,XY性腺发育不全
心脏搏动异常|R00|窦房结功能受损,昏迷,胸痛,染色体异常头昏,眩晕,心悸,心动过缓|快速的心跳,,心动过速||心脏搏动异常,心动过速,心悸,窦性心动过缓,心动过缓,短阵房性心动过速
心脏杂音和其他心音|R01|心尖区收缩期杂音,主动脉瓣区收缩期杂音,心底部连续性杂音|心脏杂音||心脏杂音和其他心音,心脏杂音,生理性杂音,杂音,心脏杂音待排,心脏杂音待查
呼吸道出血|R04|急性呕血,痰中带血,咳血,吐血,鼻衄|咯血,鼻出血||呼吸道出血,鼻衄,鼻出血,咯血
咳嗽|R05||咳嗽||咳嗽,慢性咳嗽,感染后咳嗽,变异性咳嗽,慢性咳嗽待查,慢性咳嗽痊愈
呼吸异常|R06|呃逆,屏气,喷嚏,喘鸣,喘息,口呼吸,呼吸暂停,通气过度,鼾症|呼吸异常,呼吸困难||呼吸异常,屏气发作,幼儿喘息,反复喘息,呃逆,婴儿喘息
咽痛和胸痛|R07|心前区疼痛,左前胸疼痛,咽部炎症,胸闷,呼吸时胸痛,前胸壁痛|咽痛,胸痛||胸痛,心前区疼痛,心前区不适,反复胸痛,咽痛
腹部和盆腔痛|R10|下腹痛,上腹痛,会阴痛|腹痛,盆腔痛,疼痛可放散至腰骶部或大腿内侧等||腹部痛,盆腔痛,腹痛,下腹痛,下腹不适,上腹痛,外阴痛
恶心和呕吐|R11||呕吐,恶心||呕吐,恶心,干呕,周期性呕吐,头痛呕吐
未特指的黄疸|R17|恶心,呕吐,腹泻,食欲不振,腹胀,皮肤瘙痒,腹痛,皮肤,便秘|巩膜黄染,皮肤黄染||黄疸,母乳性黄疸,病理性黄疸,生理性黄疸,轻度黄疸
腹水|R18||腹水,腹胀腹痛||腹水,腹水,大量腹水,腹水疑腺癌待查
累及消化系统和腹部的其他症状和体征|R19|发热,下腹部疼痛,便血,便秘|腹部包块,腹部不适||便血,大便干结,腹部包块,腹部不适,排便困难
皮疹和其他非特异性斑疹|R21|发烧,发痒,斑疹,点状密集皮疹,哭闹不安|皮疹,丘疹||斑疹,过敏性皮疹,皮疹,虫咬性皮疹,反复过敏性皮疹,全身皮疹
其他皮肤改变|R23|口周发绀,下唇瘀斑,发绀,皮肤黄染,巩膜黄染|紫绀,口唇发绀||其他皮肤改变,皮肤黄染,口唇发绀,发绀,口周发绀,指端青紫
异常的步态和移动|R26|剪刀步态,麻痹步态,慌张步态,醉汉步态,走路跛行,走路姿势异常,偏瘫步态|步态异常,走路不稳||步态异常,走路姿势异常,步态不稳,走路跛行,走路不稳
与排尿有关的疼痛|R30|排尿困难,排尿烧灼感|尿痛,尿频,尿不净,尿不尽,排尿困难,残余尿增多||尿痛,排尿困难,尿频尿痛
未特指的血尿|R31|尿色鲜红,尿呈暗红色,尿颜色改变,尿呈淡红色,尿呈血液状|血尿,镜下血尿||尿血,血尿,反复血尿
未特指的尿失禁|R32||尿频,尿急,急迫性尿失禁,逼尿肌收缩无力,外伤损伤尿道括约肌,医源性损伤尿道括约肌,咳嗽时尿液溢出|尿急时尿液溢出,,打喷嚏时尿液溢出,改变体位时尿液溢出,尿道持续滴尿,不能自主控制排尿|尿失禁,遗尿
多尿|R35|尿频,糖尿病,夜尿多|多尿,烦渴多饮||多尿,尿频,夜尿多,日间性尿频,尿多
头晕和眩晕|R42|脑内摇晃,头重脚轻,耳鸣,面色苍白,头胀,失眠,情绪不稳,眼花,乏力|头晕,眩晕||头晕,眩晕,头晕
言语障碍,不可归类在他处者|R47|失语,说话不清晰,构音不良,语言发育障碍|发音困难,说话不流利,表达不清||言语障碍,构音不良,语言,构音不清,吐字不清,语言表达不良
其他和原因不明的发热|R50||发热||发热,发热抽搐,发热皮疹,发热NOS,长期发热
头痛|R51|恶心,发热失语,呕吐,头晕,头部紧箍感|||头痛,头疼,反复发作性头痛
疼痛,不可归类在他处者|R52|膝关节疼痛,双下肢疼痛,上腹疼痛,下肢疼痛,关节疼痛|疼痛||疼痛,双下肢疼痛,膝关节疼痛,关节疼痛,下肢疼痛,腰骶部疼痛
晕厥和虚脱|R55|两眼发黑,四肢无力,视物模糊,头昏|虚脱,恍惚,晕厥||晕厥和虚脱,晕厥,血管迷走性晕厥,血管迷走神经性晕厥,血管迷走神经型晕厥,血管迷走性神经晕厥
惊厥,不可归类在他处者|R56|面色剧变,意识突然丧失,四肢肌肉抽搐,呼吸突然急促,阵发性四肢和面部肌肉抽动,两侧眼球上翻,神情惊恐,极度烦躁,热性惊厥|高热惊厥,惊厥||惊厥,热性惊厥,复杂性热性惊厥,CFC,高热惊厥,热性惊厥附加症
出血,不可归类在他处者|R58|皮肤瘀斑|皮肤出血||出血,皮肤瘀斑,瘀斑,右跖瘀斑,皮肤出血
淋巴结增大|R59|淋巴结压痛,淋巴结触痛|淋巴结肿大||淋巴结增大,颈部淋巴结长大,颈部淋巴结肿大,淋巴结长大,颈淋巴结长大,耳后淋巴结长大
多汗症|R61|全身性多汗,局部性多汗,夜间多汗|多汗||多汗症,多汗,多汗症,盗汗,夜间多汗
未达到预期正常生理发育水平|R62|性器官和第二特征发育不良,体重低,运动发育落后,头围增长下降|生长迟缓,身材矮小,营养不良||生长发育,生长偏离,运动发育落后,生长迟缓,青春晚期
有关食物和液体摄取的症状和体征|R63|面色萎黄,形体消瘦,进食不足,饮水不足|食欲下降,体重异常,厌食,烦渴||厌食,轻度低体重,食欲下降,体重增长差,体重减轻
其他的一般症状和体征|R68|口干,杵状指,软腭麻痹,心肌炎,毒血症,肾上腺功能障碍,阵发性哭闹,哭闹,发绀|声嘶,夜间哭闹||哭闹,夜间哭闹,阵发性哭闹,口干,哭闹发绀
血清酶水平异常|R74|转氨酶增高,胆汁酸增高|血清酶学增高||血清酶水平异常,胆汁酸增高,转氨酶增高,血清酶学增高,神经元特异性烯醇化酶增高,胆汁酸升高
尿的其他异常所见|R82|尿隐血,血尿,夜尿增多|蛋白尿,尿不尽||尿隐血,尿不尽,血尿蛋白尿,夜尿增多,尿动力检查后
头部开放性伤口|S01||疼痛,红肿,瘀斑,血肿,伴血管神经骨损伤,外露,骨折,LeFort骨折,骨折段移位,咬合错乱,眶区淤血,舌后坠,呼吸困难,前牙开牙合,耳前区疼痛肿胀,出血,血肿,咬合紊乱,开口受限,咀嚼障碍,呼吸困难,吞咽困难,言语障碍,开口受限,复视,出血淤血,紫青色瘀斑,眶下区麻木,眼睑闭合不全|擦伤,挫伤,蜇伤,挫裂伤,刺伤,切割伤,撕裂伤,砍伤,咬伤,烧伤,火器伤|
颅骨和面骨骨折|S02|||脑部创伤出血|
眼和眶损伤|S05||疼痛,畏光,流泪,视力减退甚至丧失,基质层增厚,水肿,浑浊,瞳孔括约肌断裂,调节麻痹,近视力障碍,瞳孔扩大,复试,前房积血,眼压升高,角膜内皮损害,视物变形,前房变浅,黄斑水肿,虹膜震颤,高度远视,晶状体脱位,视网膜脱落,脉络膜破裂,视网膜水肿变白,角膜可变形,虹膜脱出,虹膜钱盾,晶状体破裂,白内障,眼后段损伤,眼痛,流泪,视力下降,眼内出血,眼眶淤血,水肿,泪小管断裂,眼眶骨折,眼眶出血,眼眶气肿|眼外伤病史,角膜挫伤,虹膜睫状体挫伤,晶状体挫伤,玻璃体积血,脉络膜和视网膜挫伤,眼球裂伤,眼球穿透伤,眼异物,眼睑挫裂伤,泪小管断裂,眼眶骨折,眶出血,眶气肿,视神经损伤,酸碱化学伤,热烧伤,紫外线灼伤|
颅内损伤|S06|呼吸微弱,恶心,呕吐,血压下降,意识障碍,头痛,脑水肿,瞳孔异常,精神障碍,脉搏浅弱|颅脑损伤,脑损伤||颅内损伤,脑损伤,脑损伤后,脑损伤后遗症,早产儿脑损伤,左侧脑损伤
头部其他和未特指的损伤|S09||头皮包块,头皮疖疮,头部损伤,头皮血肿,头皮脱伤,头皮裂伤,头部外伤,头部血肿||头部其他和未特指的损伤,头皮血肿,头部外伤,头部外伤后,头部血肿,头皮疖疮
在颈水平的关节和韧带脱位、扭伤和劳损|S13|脊髓压迫,血管压迫,瘫痪,全身症状,高热|头部向一侧倾斜,斜颈,颈髓压迫,延髓压迫,四肢麻木,颈部肌肉萎缩,手指精细功能障碍,行路不稳,踩棉花感,四肢运动麻痹,吞咽困难|颈痛,颈枕部疼痛,头晕,头痛,眩晕,恶心呕吐,视力障碍,活动受限|
腹部、下背和骨盆浅表损伤|S30|脊髓压迫,间歇性跛行症状,畸形|腰椎骨质增生,腰椎间盘脱出,腰部关节畸形,腰背痛,腰部酸痛,腰部神经痛,肌肉僵硬,背部僵直,腰背麻木,下肢剧烈麻痛,灼痛,腰抽痛,腰串痛|腰部胀痛,腰部麻木,腰部疲乏感,弯腰受限|
肩和上臂骨折|S42|肌肉急性缺血坏死,神经失营养麻痹,血管损伤,局部水肿,神经损伤|外伤史,关节活动障碍,功能障碍,休克,发热,脂肪栓塞综合征|局部疼痛,局部肿胀,局部瘀斑,畸形,异常活动|
腕和手其他和未特指的损伤|S69|全身症状,贫血,休克|外伤史,手部关节损伤,手部功能障碍,手部关节活动障碍,手部神经损伤,手部血管损伤|皮肤损伤,手出血,手疼痛,手麻木,肌腱损伤|
髋关节和韧带脱位、扭伤和劳损|S73|出血性休克,内脏损伤,假性瘫痪|外伤史,髋部疼痛,髋部肿胀,髋部功能障碍,髋关节疼痛,髋关节不能自主活动,髋关节自主活动受限,患肢缩短,髋关节畸形,坐骨神经损伤,足下垂,趾背伸无力,足背外侧感觉障碍|髋关节前脱位,髋关节后脱位,髋关节中心脱位|
膝关节和韧带脱位、扭伤和劳损|S83|骨质疏松|外伤史,骨折,周围神经损伤,肌肉萎缩,挛缩畸形,关节功能障碍,关节屈曲,外伤史|关节疼痛,关节肿胀,关节肿块,关节脱位|
足骨折,除外踝|S92|足部缺血性坏死|足部活动剧痛,足部关节活动障碍,足部关节功能障碍|足部疼痛,足部肿胀,足部皮肤损伤,足部关节畸形,足部骨擦音,足部骨擦感|
呼吸道内异物|T17||剧烈咳嗽,憋气,窒息|异物吸入病史|
操作并发症,不可归类在他处者|T81|||严重龋病,严重牙周病,牙髓坏死,多生牙,错位牙,埋伏牙,牙列拥挤,磨牙颊向错位致口腔溃疡,阻生牙,牙外伤,乳牙滞留,病灶牙,四环素牙等|
无主诉或诊断报告的人接受的其他特殊检查和调查|Z01||检查,复查||孕前检查,检查,妇科检查,复查,查体
避孕问题|Z30||宫内节育,安环,避孕,结扎||避孕问题,IUD,分粘,安曼月乐环后,安环,取环
生育问题|Z31||人工受精,精子计数,生育咨询,绝育术,输卵管疏通||生育问题,生育咨询,生育,咨询供精,人工授精,隐睾咨询
附带妊娠状态|Z33||并发症,卵巢过度刺激综合征,腹胀,卵巢增大,大量胸腹腔积液,电解质紊乱,,多胎妊娠,流产,胎停|主要针对输卵管性不孕症,原因不明的不孕症,子宫内膜异位症,男性因素不育症,排卵异常,宫颈因素等不孕症|
高危妊娠监督|Z35||雌孕激素下降,胚胎死亡,胚胎停育,阴道出血||高危妊娠监督,胚胎停育,胎停,清宫
分娩的结局|Z37|影响因素,产力,子宫收缩力,腹壁肌及膈肌收缩力,肛提肌收缩力,,产道,骨产道,软产道,,胎儿,胎儿大小,胎位,胎儿畸形,,精神心理因素|第一产程,宫颈扩张期,初产妇11-12小时,经产妇6-8小时,,第二产程,胎儿娩出期,初产妇1-2小时,经产妇1小时以内,,第三产程,胎盘娩出期,不超过30分钟|规律宫缩,宫口扩张,胎头下降,胎膜破裂,包括以下过程,衔接,下降,俯屈,内旋转,仰伸,复位及外旋转,胎肩及胎儿娩出|
非以改善健康状况为目的的操作|Z41||脂肪抽吸,自体脂肪移植,自体脂肪软组织填充,抽脂减肥,美容,面部皱纹|阴道再造,会阴整形,鼻梁成形,重睑,眼袋,颧骨增高,隆胸,隆乳,腹壁松弛整形,缩乳,乳房再造,巨乳,注射美容|
涉及整形手术的随诊医疗|Z42||缺损修复,畸形修复,瘢痕修复||
涉及整形手术的随诊医疗|Z42|||下颌前突,地包天,下颏后缩,鸟嘴畸形,下颌缘肥大,下颌缘弯曲不平,下颌角肥大,下颌角外翻,下颌角内番,下颌角双侧不对称,面部倾斜,咬合异常|
涉及整形手术的随诊医疗|Z42|||耳廓畸形,招风耳,菜花耳,杯状耳,隐耳,无耳,副耳,多耳,小耳畸形,巨耳,外耳道狭窄,外耳道闭锁|
涉及整形手术的随诊医疗|Z42||镶牙,牙体缺损,龋齿,外伤,磨损,酸蚀,牙发育畸形,牙列缺损,龋,牙周病,外伤,炎症,肿瘤手术,牙列缺失,龋,牙周病,不良修复体,发育异常,颌面缺损,唇裂,腭裂,外伤,肿瘤手术,放疗,口腔炎症,颞下颌关节紊乱病,咀嚼肌疼痛,开口障碍,关节声响|俗称镶牙,种植修复,粘结修复,美学修复|
其他装置的安装和调整|Z46|||龋齿,楔状缺损,牙外伤,牙折|
为其他咨询和医疗指导而与保健机构接触的人,不可归类在他处者|Z71||咨询||咨询,结果咨询,产前咨询,孕前咨询,孕妇咨询
